a!	INTERJ	Oh!, Whew!
ab	ART	INDEF
abada	ADV	forever
abal	V	lend
abale	V	borrow out
abdu	N	long robe
Abijaṉ	N	Abijan
abiyon	N	airplane
able	V	lend
aca	V	go.IMP, go on, go away
afeer	N	affair, business
Afrik	N	Africa
ag	CNJ	with
ag	PRPO	on, by
ag	CNJ	and
agaraaf	N	suture; hook-and-eye fastener
agsi	V	arrive
aj	N	pilgrimage during the Tabaski season
aj	V	put on top
ajaa	N	woman who has been to Mecca on a Tabaski pilgrimage
ajaratu	N	female pilgrim
aji	V	go on pilgrimage
aju	V	be hung up
ak	PRPO	with
ak	PRPO	on, by
ak	CNJ	and
aka	INTERJ	how
akara	N	bean cake
aktiwite	N	activity
Aku	N	Creole
alal	N	goods, fortune
alaafiya	N	chance, freedom
Alaaji	N	male pilgrim
albati	V	turn around turn inside out
Alet	N	Sunday
alfa	N	Teacher in a Koranic school
alfun	N	million
aljana	N	heaven
Alhamdulilaahi!	INTERJ	Thanks be to God!
Alkaali	N	head of the village
alkaati	N	policeman
alkol	N	alcohol
allaaji	N	man who has been to Mecca on a Tabaski piligrimage
allayhi	N	the Prophet Mohammet
almet	N	match
almoor	N	cupboard
Almuudu	N	arabic scholar
aloor	CNJ	well, then; well, so
Alseri	N	Algeria
Altine	N	Monday
alxamdulilaa	INTERJ	praise to be God
Alxamdulilaaxi	INTERJ	Thanks be to God!
Alxames	N	Thursday
Alxamis	N	Thursday
Alxuraan	N	the Koran
am	V	have in it; get a seat on
am	V	for there to be
am	CNJ	or; or not
Am!	INTERJ	Here!, Take it!
amaana	ADV	maybe
amal	V	create, find, locate
am-am	N	property
amati	V	still have
amatul	V	not to have any more, there is/are no more
ambaasaad	N	embassy
ambasaad	N	embassy
am-di-jamma	N	acquaintance
am-di-jàmm	N	acquaintance
ame	V	hold; take care of;
ameel	V	owe to 
ameel	V	owe
amel	V	be in debt
Amerik	N	America
Amerikeṉ	N	American
Amet	N	Moor
amiin	INTERJ	amen
ampagaay	ADV	in abundance
amul	V	not to exist
amut	V	not to exist
amxar	N	split open
am-xel	V	be smart
am-yaram	V	be fat, put on weight
an	V	gather up from the floor, with the hands or a dustpan
ana	Q	where is, where are; how is, how are
anaago	N	frock
anam	ADV	where is it
anam	N	manner;
and	N	clay pot, placenta
anda	N	censer
andaar	N	unit of measure for grain 
andandoo	N	companion
Angale	N	English
Angalteer	N	England
aniin	N	blue makeup
aniin	V	put blue makeup
aniinu	V	have blue makeup
ankay	PRT	yes
antal	V	be able to lift, endure
antan	V	be able to lift, endure
anukaay	N	dustpan
anxkay	PRT	yes
anyi	N	some
añ	V	eat lunch
añ	N	lunch
añaan	V	be jealous, be envious, be selfish
añaane	V	be jealous
añaanee	V	be jealous of
añee	V	have for lunch, lunch at
añi	V	go and eat lunch
añsi	V	come and eat lunch
appaat	V	have trouble breathing
apparànti	N	conductor; apprentice
apparanti	N	apprentice
apre	CNJ	then; and then
Araab	N	Arab; Arabic language
araam	V	be immoral
araf	N	alphabet, letter
arankees	N	money box
araw	V	make small balls of millet flour
arbiis	N	foot infection caused by worms
arbit	N	referee
are	N	bus stop
areet!	INTERJ	stop!
areete	V	stop
aréén 	N	peanut
arikoo	N	bean
arive	V	be successful, have arrived
ariwe	V	be successful
arjana	N	heaven
armeel	N	grave
armeel	N	cemetery
armoor	N	armoire, closet
armuwaar	N	armoire, closet
artu	V	be careful
as	V	bail out, scoop water out of
as	ART	INDEF
asaka	N	annual tithe given to the mosque
asamaan	N	sky
aset	N	plate, Saturday
Aséér	N	Saturday
askan	N	family inheritance
aspirin	N	aspirin
asporo	N	aspirin
Assalaamaalekum	INTERJ	hello
astafurlaa!	INTERJ	may God forgive me!
astamalaak	ADV	let alone, much less
at	N	year
ataaya	N	tea party
ataliye	N	workshop
attaaya	V	have tea
attaaya	N	tea
aviyon	N	airplane
avokaa	N	lawyer
aw	V	pass through
aw	ART	INDEF
awaṉs	PRPO	by
awaṉse	V	advance
awokaa	N	lawyer
Awril	N	April
ay	ADJ	some trouble
ay	N	turn
ay	N	quarrel
ay	N	quarrel
ay	QUANT	some
ay	INTERJ	Hey!
ayca	INTERJ	let's do it
aye	V	take one’s turn
aye	V	on duties
ayropoor	N	airport
aaba	V	borrow
aabaket	N	borrower
aada	N	custom
aaduna	N	world, generation
aaga	V	reach
aaji	V	unhook, hit a target, bring down
aajo	N	need, anxiety, be respectful
Aajuma	N	Friday
aaka	V	confront
aala	N	forest, bush
Aalarba	N	Wednesday
aalim	N	scholar
aaluwa	N	wooden writing tablet
aanda	V	go together
aapal	V	limit
aar	V	protect
aar	N	protection
aaralba	N	Wednesday
aas	N	ace
aat	N	uncircumsized person
aatee	V	judge, separate
aateekaay	N	courthouse
aateekat	N	magistrate
aawa	N	first wife
aawlu	V	have bad luck
Aawsa	N	Hausa person; Hausa language
aaxa	N	sin
aay	V	be bad, be mean; be good at what one does, be smart
aay	N	ill-lock
aaya	N	verse of the Koran
aaye	V	deprive of, fail to share
aaye	V	prohibit
aayee	V	deprive, prohibit
aay-gaaf	V	be ill-fated
aayṉ	V	play a game
àbb	V	borrow
àbbaas	V	borrow
àddina 	N	world, life
àddu	V	answer
àdduji	V	go and answer
àdduna	N	world, life
àgg	V	arrive there
àggale	V	finish
àggali	V	finish
àggële	V	finish
àggëleel	V	finish
Àjjana	N	Paradise, Heaven
àjji	V	to get down, slap
Àjjuma	N	Friday
àkk	V	start a fight with
àkki	V	go and start a fight with
àkksi	V	come and start a fight with
àll	N	rural area, area outside one’s normal experience
àllaaji	N	man who has been to Mecca on a Tabaski pilgrimage
Àllaaxira	N	remote place where people go when they die, or the end of the earth
Àllarba	N	Wednesday
àlluwa	N	wooden tablet
ànd	V	go together
àndal	V	accompany
àndandoo	V	be accompanied by
àndandoo	N	companion
Àngale	N	English person, English language
Àngalteer	N	England
àpp	N	limit
àppal	V	give a limit
àq	N	offense
àttan	V	be able to carry
àttan	V	be the one to
àtte	V	judge
àtte	V	judge between
àttekaay	N	courthouse
ba	PRPO	until
ba	DET	DEF
ba	V	leave
ba	V	separate from
ba	V	let
ba	V	stop
baa	N	stockings
baaca	V	thresh
baadoola	N	poor person
baadoolo	ADJ	peasant
baadoolo	N	unsophisticated person
baag	N	pail for drawing water
baagante	V	go back and forth
baakaar	N	sin
baakanti	V	return, change direction
baakarkat	N	sinner
baaku	V	glorify oneself invite an opponent in wrestling contest
baal	V	forgive; give up one’s share of something to
baal	N	dance, party
baal	V	dance
baalal	V	forgive
baalu	V	ask for forgiveness
baambaane	V	baby sit
baambaanekat	N	baby-sitter
baameel	N	cemetery
baamtu	V	repeat
baamtuwaat	V	repeat
baana-baana	N	street vendor
baandaas	V	bandage, dress
baaneex	V	be happy, joy
baaneexu	V	rejoice
baanga	N	pumpkin, squash
baanganooye	N	timid person
baar	V	boil down
baar	N	bar
baaraam	N	finger, toe
baaral	V	simmer
baaralal	V	simmer
baare	V	barricade, prevent
baase	N	couscous served with a meat or chicken sauce
baase	N	Senegambian dish
baasi	N	couscous served with a meat or chicken sauce 
baat	N	neck, neckline, throat; voice; word, speech
baatale	V	leave a message with someone for somebody
baatim	N	power to predict the future
baatre	V	shuffle
baawbaab	N	baobab tree
baax	V	be kind; not to be spoiled; be fixed
baax	N	custom
baaxental	V	celebrate
baaxle	V	do well
baaxoñ	N	crow
baay	N	father, paternal uncle
Baay	N	term of address for a man
baay	V	leave
baay	N	withdraw
baay	V	cancel
baayale	V	designate to serve as a substitute father for 
baayee	V	leave with
baayeekoo	V	come from
baayi	V	leave
baayi	V	let
baayi	V	stop
baayo	N	orphan
baayoo	V	act as a substitute father for
bagaas	N	baggage
bak	N	high school diploma
baken	N	nose, life
bakkan	N	nose
bakku	N	ladle
bal	N	ball, balloon
balankaar	N	stretcher
balanse	N	white wash
balanse	V	white wash
balbastik	N	ice cream
bale	V	sweep
bale	N	broom
balekat	N	sweeper
balliñe	N	xylophone
ban	PRO	which
ban	N	clay, mud
ban	V	please
banaana	N	banana fruit
banaana	N	banana plant
bandaas	N	bandage
banjooli	N	Ostrich
bank	V	bend
banka	V	broke
banka	V	bend
banku	V	be bent
bant	N	wood, stick
banta	POSTP	out, outside
banta	ADV	ready, finished, outside
banta	N	stick, log
banxaas	N	branch
bañ	V	refuse
bañ	V	hate
bañ	V	not want
baña	ADV	of course
bañ-bañlu	V	pretend to refuse
bañar-bañari	V	swaying of the hips, walking
baṉ	N	bench
bar	V	talk very fast
bar	V	stammer
bar	N	container for drawing water made from a hide
bar	N	iguana
baraada	N	teapot
baraag	N	hut, shack
barab	N	place
baram	V	twist, tangle 
baram	N	type of twisted hair braid, dreadlock
baramu	V	be twisted
barastiku	V	slip
bare	V	be many
bare	V	have a lot of 
bari	V	be many
bari	V	have a lot of 
bari	CNJ	but
bari	N	plenty, surname
barigó	N	metal storage drum
barigó	N	hundredweight
barke	N	blessing; good fortune
barkeel	V	be blessed
barkeel	N	blessing
barkeelu	V	be blessed, have good fortune
barkeeluji	V	go and get blessed
basaab	N	sorrel; drink made of green sorrel
basaṉ	N	mat
Basari	N	Bassari person, Bassari language
bataaxal	N	letter, article; sentence
bataael	N	letter
batañse	N	eggplant
batanse	N	eggplant
bato	N	boat
batuwaar	N	meat market
Batuwaar	N	district of Dakar
Bawol	N	Baol
Bawol-bawol	N	person from Baol, be from
bax	V	be really angry
bax	V	boil, bubble
baxa	V	be light blue
baxa	N	sky blue color
baxal	V	boil
baxalal	V	boil for
baxaw	V	weed millet fields for the first time
bay	V	farm
bay	V	cultivate, dig up
bayal	V	cultivate
baya'l	N	park, empty ground
bayaal	N	public square
baye	N	park, empty ground
baykat	N	farmer
bàcc	V	beat; separate; rinse
bàcc	N	water for rinsing clothes
back-bàccal	V	beat up
bàjjan	N	aunt
bàjjen	N	aunt
bàkk	V	praise
bàkk	N	song of praise
bàkkaar	N	sin
bàkku	V	brag
Bàmbara	N	Bambara person; Bambara language
bàmmeel	N	grave
bàndaas	N	bandage
bànjóóli	N	ostrich
Bànjul	N	capital of Gambia
bànk	V	be out of money, be broke 
bànk	N	state of being broke
bànneex	N	pleasure
bànqaas	N	branch; neighborhood
bàq	N	tripe
bàttu	N	small calabash; large wooden spoon
bàyyante	V	separate
bàyyeekoo	V	come from
bàyyeeku	V	rest
bàyyente	V	separate
bàyyi	V	leave; get rid of
bàyyi	V	let 
bàyyi	V	stop
bàyyima	N	animal
be	V	be:3SG, be:3PL
be	PRPO	until, up to
bё	PRPO	unil
becak	N	noon
bee	PRO	DEM
beekoor	N	drought
beer	N	beer
bees	V	be new
bees	V	winnow
beew	V	be rude, be sulky
bejjaaw	V	have ray hair
bejjaw	N	gray hair
bekkoor	N	drought
ben	PRO	none, any
benacin	N	wolof dish
beneen	PRO	another, next one
Beniṉ	N	Benin
benn	NUM	one
benn	DET	INDEF
benna	NUM	one
bentenki	N	silk cotton tree
beñe	N	doughnut-like cake, dough nuts
beñe	V	process the making of pancake
beñuwaar	N	washing pan
ber	V	separate
beref	N	watermelon
beru	V	be isolated,
bes	N	day
besexeene	N	negligent
bett	V	surprise
bette	V	be surprising
bey	V	cultivate
bééco	N	traditional knee-length undergarment
béejin	N	horn, horn animals
bééy	V	have an infected finger
bééy	N	marble
bééy	V	play marbles
bég	V	be happy
béjjën 	N	horn of an animal
bépp	QUANT	every, each
béréb	N	place, spot
bés	N	day
béy	N	goat
bë	PRPO	until, up to
bë	DET	DEF
bë	PRO	DEM
bëccëg	N	daylight, daytime
bëcëg	N	afternoon
bëcëk	N	afternoon, noon
bëër	N	butter
bëg	V	be content
bëgg	V	want, love
bëgg	V	want to
bëggé	V	be stingy
bëkk-néég	N	confidant of a king or religious leader
bëlaa	PRPO	before	
bëlé	PRO	DEM that
Bëlot	N	name of card game
bëmëx	V	push
bën-bën	N	opening
bënn	V	pierce
bënn	V	have a small hole
bënn-bënn	N	hole, opening
bënnle	V	be greedy for food
bënnu	V	have pierced ears
bëñ	N	tooth
bër	V	be on vacation
bëré	V	fight
bëré	N	fight
bërét	V	jump up
bërëb	N	place, spot location
bërëṉ	V	roll
bërëṉu	V	roll
bërgël	V	abandon; fall to care for
bër-set	N	daybreak
bës	N	day
bët	N	eye
bëtël	V	postpone
bët-set	N	daybreak
bëtt	V	pierce
bëy	N	goat; person who doesn’t know how to behave
bëy	V	farm
bëy	V	cultivate
bëykat	N	farmer
Bëyruut	N	Lebanese; Syrian
bëyukaat	N	framing tools, implements
bi	PRPO	when, since
bi	DET	DEM
bi	PRO	DEM
bi	V	be
bidaa	N	superstition
biddééw	N	star
biddënti	V	oversleep, get up late
bif	V	pull sharply on
bii	DET	this
bii	PRO	this
bii	V	take, draw
bii	ADB	today
biig	ADV	last night
biij	V	bend, sway, twist
biiñ	V	sneer
biiñ	N	wine
biir	N	stomach, abdomen
biir	N	pregnancy
biir	PRPO	inside
biir	V	be pregnant
biiral	V	get someone pregnant
biiw	V	surround
biiw	V	buzz around food especially files
biiy	N	marble
biiy	V	play marbles
bijjaaw	V	have gray hair
bijjaaw	N	gray hair
bilé	DET	DEM.visible
bilé	PRO	DEM.visible
BillAahi!	INTERJ	I swear it!
BillAay!	INTERJ	I swear it!
bind	V	write
bind	N	form
binda	V	write
bindakat	N	writer
bindaan	N	maid
bindal	V	write for someone
bindkat	N	writer
bindu	V	look for work as a domestic or laborer, book oneself, be employed especially as a made
bindukaay	N	pen
bippa	V	jerk
biró	N	office
bisaab	N	sorrel; drink made of green sorrel
bisaap	N	sorrel drink
bisimilAahi	INTERJ	in the name of God!
bismilAay	INTERJ	in the name of God!
bitarñeku	V	be inside out
biti	ADV	outdoors
bitik	N	store
bitiloxo	V	hit someone with the back of one’s hand
biyeer	N	beer
bojj	N	pound to remove the hulls
bokk	V	belong to the same family or group
bokk	V	share, split
bol	N	flour
boli	N	throat
boli	N	Adam’s apple
bolog	N	robe
bomb	V	rub, polish
bon	V	be bad, pour
boṉ	ADV	well! Whatever!
bonde	V	bounce
bondeel 	V	bounce
boo	CNJ	if, when
booba	ADV	at the moment, at that time
boobu	DET	DEM.out_of_sight
boobu	PRO	DEM_out_of_sight
book	CNJ	then, in that case
bool	N	bowl
boole	V	coordinate; cause a disagreement; mix
boolox	V	kill
boopa	N	leader
boor	N	outside, edge
boor	N	facing side, part
booral	V	rub something around the edge
booru	ADV	near; on the other side of
boot	V	put on one’s back and wrap it up; be responsible for
booy	V	have a rash between one’s legs
booy	N	servant; inferior person
booy	N	term of address used by young people, mainly men
bopp	N	leader
bopp	PRO	REFL.self
bor	N	dept
bori	V	have a nosebleed
borom	N	owner
boroode	V	embroider
boroode	N	embroidered material
boroom	N	owner; person associated with, expert on
bos	N	possession
bos	N	hump
botti	V	remove someone from one’s back
boy	V	be red hot and ready to cook on
boyal	V	start heating
boyet	N	box
bóbbëli	V	yawn
bónaa	N	pierce
bón-bónaa	N	hole
bónna	V	perforate
bóñ	N	tooth
bóóbali	V	yawn
bóóf	V	incubate
bóóli	N	large bowl
bóq	V	put something under one’s arm
bór-bóri	V	run
bórig	N	barrel
bóróngu	N	roll on the ground
bórón	V	roll
bórset	N	day break
bós	V	massage
bóta	V	crawl under
bótset	N	day break
bów	V	bark
börset	N	day break
böt	N	eye
bötset	N	day break
bruy	N	noise
bu	PRT IMP.NEG
bu	Q	which, which one
bu	DET.INDEF	any, that, anything that
bu	CNJ	if, when
bubu	N	boubou
buddi	V	extract
bugga	V	want, like
buggé	V	be selfish
buja	V	beat, insult
bujul	V	get away
bukki	N	hyena, wolf; ugly person
buklé	V	be curly
bul	IMP.NEG	don’t
bulet	N	fried ball of ground fish or meat
bulo	V	be blue
bulo	N	blueing powder for whitening laundry; blue
bulo	V	hit with one’s fist
bulóo	V	be blue
buma	CNJ	if, when
bungeen	CNJ	if, when
bunt	N	door
bunta	N	department
bunu	CNJ	if, when
buñu	CNJ	if, when
bureét	ADV	all of sudden
buréy	N	penny, two bututs
burum	V	fall
buruwet	N	wheel barrow
buteél	N	bottle
butéél	N	bottle
butik	N	store
butit	N	intestines; umbilical cord
butoṉ	N	button
butti	V	slash
buub	V	gather up
buukël	N	buckle
buuj	N	type of shellfish 
buum	N	rope
buum	N	piece of music
buum	V	give allowance
buur	N	king; queen
buux	V	jostle
buux	V	give to surreptitiously
buy	N	baobab fruit
buy	V	be substantial, increase in quantity
bwaat	N	box
ca	PRPO	to, of, about
ca	QUANT	some
caa	EXCL	ooh!
caabi	N	key
caabi	V	lock
caacaay	V	be mischievous
Caad	N	Chad
caadi-caadi	V	to roll on the ground
caaf	N	roasted peanuts
caameñ	N	brother
caamoñ	N	left hand
caangaay	N	shroud
caapa	N	vagina
caas	N	tendon; fishing line
caat	N	youngest child in a family
caatloo	V	have someone as one’s youngest child
caax	N	net
caax	N	net undershirt
caaxaan	V	joke, kid around
caaxaan	N	jokes, unimportant remarks
caaxaankat	N	joker
caaxoñ	N	necktie; gills
caaxoñu	V	be dressed up
caay-caay	N	exploit, prank
caaya	N	traditional full men's pants; type of women’s pants
cabax	V	stab
cabb	N	cluster
cabba	N	brunch
cacca	N	theft
cafaay	N	sauce for laax
caf-caf	N	taste
cafka	N	flavor
cafko	N	flavor
caga	N	prostitute; unmarried woman
cagga	N	prostitute
caggatu	N	prostitution
caku	N	parrot
cal	V	gallop
cal-cali	V	gallop away
calal	N	chain
cam	INTERJ	express disgust or pride
caṉ	V	be stuck
canggaay	N	ritual bath for a sick or dead Person
capp	V	dip into a little way
caq	N	bead necklace
carax	N	sandal
carax	N	slippers	
car	N	branch, switch; thong
cas	V	grab quickly
casgin	V	be in mood, be in trend
cat	N	edge, woe, ill-fortune, sharp-edge
catu	V	admire someone and thus provoke a bad fate
caw	V	beat with a strap or switch
cax	V	ask someone a riddle
cax	N	riddle
cax	N	puzzles
cax	N	shark
caxxa	N	local beeds worn around the neck
càcc	N	theft
càcc	N	robbery
càmmiñ	N	male friend of a woman; brother of a woman
càmmooñ	N	left side; left hand by extension, when visible
cànggaay	N	clothing allowance
Ceddo	N	Senegalese person who follows traditional African religion
ceeb	N	rice
ceen	N	chain
Cees	N	Thies
cell	V	be completely quiet
cere	N	couscous made from millet
cet	N	hygiene
céetal	N	honeymoon
cééli	N	vulture
céét	N	wedding ceremony
céy	INTERJ	surprise
céyt	N	wedding celebration
cëla	N	junction
cër	N	part; status
cër	N	parts of the body
cërpi-cërpi	V	jump about in a confuse manner
cëyt	N	wedding celebration
ci	PRPO	to, of, about, at, with, in there
ci	QUANT	some
ciif	N	provincial chief
ciiñ	N	gum
ciipëtu	V	make a contemptuous noise with one’s lips
ciipu	V	make a contemptuous noise with one’s lips
cim	INTERJ	disdain or disgust
cin	N	pot, food
cof	V	just barely touch
cofel	N	faith
col	N	style
coleen	N	style
colin	N	style
coll	N	top
como	N	beginner
compa	V	take a small bit
conco	N	elbow
coñ-coñ	N	elbow
coobare	N	whim, pleasure, intention
coof	N	type of fish
cooka	N	pubic hair
cookeer	N	bush fowl-known to be wise
coono	N	tiredness; responsibility
coono	N	difficulty, struggle, suffering
cooral	V	throw with fare
cooroon	N	period before the rains
coota	N	clitoris
coow	N	noise
coppret	N	clitoris
coq	V	pester someone to tell one something
coqom-coqomi	V	smack one’s lips
coqotaan	V	tickle
coro	N	girlfriend, boyfriend
coroxaan	V	be choking on something
coroxaan	V	choke
cosaan	N	custom
cosaanoo	V	originate from
cott	N	clitoris
cox	N	hulls of pounded grain that don’t go through a sifter
cox	N	chaff
coy	N	parrot
coy	N	police
coy	ADV	very
cófit	V	pick up quickly
cóñcó	V	elbow
cóola	N	clitoris
cu	N	stew
cubalo	N	fisherman
cukum	V	braid one’s hair in little braids
cukumu	V	braid one’s hair in little braids 
cumbux	V	plunge in
cur	ADV	very
curr	IDEO	very
curux	V	slip in unexpectedly
cus	N	nipple
cuub	N	tie-dyed cloth, dye, tye-dye
cuubkat	N	tie-dyer
cuuc	N	chick
cuuc	V	prick
cuuce	V	be something that pricks
cuucu	N	penis
cuuj	N	chick
cuukel	N	bump at the back of the skull
cuuné	N	beginner
cuuraa	N	porridge
cuuraa	N	incense
cuuraay	N	incense
cuut	V	prick
cuuté	V	be something that pricks
cuwuñ	V	poke
chaal	N	scarf
cheef	N	leader
cheen	N	chain
chingom	N	chewing gum
Chinwaa	N	Asian person; Chinese language
chofëër	N	driver
chokolaa	N	chocolate
chokolaa	V	be brown
chuppome	N	cabbage
daa	N	ink
daa	PRO	3SG.V.FOC
daabux	V	insert
daadi	CNJ	then
daagu	V	walk slowly
daaj	V	pound, put in
daaj	V	nail
daajal	V	put in
daaju	V	be very short; be pounded
daaju	V	be drunk
daakaande	N	gum, starch
daakaande	V	apply gum or starch
daal	PRPO	as for
daal	INTERJ	certainty
daala	N	shoe
daala	ADV	near
daam	N	queen in cards
daamar	N	car
daan	V	win a wrestling match, argument, throw something down, overwhelm someone with one’s arguments
daan	V	AUX.PST.DUR
daan	V	defeat
Daanaan	PRT	audience response
daanaka	ADV	in fact
daanaka	ADV	almost
daanel	V	knock down
daanu	V	fall down
daanu	V	fall
daaṉi-daaṉi	V	run
daar	N	cow
daara	N	Koranic school
daas	V	sharpen
daaw	ADV	last year
daaw-jéég	ADV	two years ago
daaxa	V	drive away, turn down
daaxa	V	surprise
daaxee	V	run after
daay	N	type of leaf used in medicine
dab	V	catch up with
dafa	PRO	3SG.V.FOC
dag	N	royal servant
dagaan	V	worship
dagan	V	be legal, be necessary
dagg	V	cut
dagg	V	cut oneself
daggale	V	be really tired
daggat	V	cut into little pieces
dagg-dagg	N	cut
daggit	N	little piece
dagit	N	local african blouse
daj	V	feel, encounter
daj	V	have done everything
dajale	V	put together
dajaloo	V	come together
daje	V	meet
dajee	V	meet
dajjant	V	be sleepy
Dakaar	N	Dakar
dal	V	stop of a pounding or hitting process; hit a target
dal	V	stay temporarily at
dal	V	happen to; fall on, hit
dal	V	lodge, confront, fall
dalal	V	stay temporarily with
dalasi	N	unit of the Gambia currency
daldi	ADV	immediately
dama	PRO	3SG.V.FOC
damm	V	break
damm	V	break
damm-damm	N	fracture
Dammel	N	King of Cayor
dampa	V	massage
damu	V	boast
damye	N	checkers
damye	V	play checkers
damyeji	V	go and play checkers
danga	V	be:2SG
dank	V	roll balls of food
dank	N	ball of food
danka	V	make first, curse, form balls when eating food with the hand
danu	PRO	1.PL.V.FOC
danu	PRO	3.PL.V.FOC
dañu	PRO	1.PL.V.FOC
dañu	PRO	3.PL.V.FOC
daṉ	V	be thick
daṉ	V	be tight on, tight for
daṉar	N	venom
daṉi-daṉi	V	run helter-skelter
daṉtist	N	dentist
daqaar	N	tamarind tree
dar	V	stick on the bottom of a pan
dar	V	plaster a floor
dara	PRO	nothing; something; anything
daraapoo	N	flag
daraayba	N	driver
darab	N	sheet
daraja	N	prestige
daraja	V	be famous
daral	N	stockyard
daral	V	rebuke
darap	N	sheet
darkase	N	cashew fruit, cashew nut
daw	V	run
dawal	V	drive, deposit
dawalal	V	drive for someone
dawalal	V	give someone an amount as a deposit for someone
dawal	N	deposit
dawalkat	N	driver
dawume	N	embroidery
dax	N	butter
daxaar	N	tamarind
day	V	be dull of a knife
day	V	have a bowel movement
day	N	bowel movement
day	N	faeces
day	V	defecate, lie
dàjji	V	demolish; wear someone out
dàkkantal	N	name of an ancestor
dàkkànde	V	starch
dàkkànde	N	starch
dàkkoor	V	agree 
dàldi	CNJ	then
dàll	N	shoe
dàmp	V	massage
dànq	N	type of tropical seed, crushed to make a powder that is formed into sculptures which are then soaked in perfume
dàq	V	pursue
dàq	V	expel from
dàq	V	be better than
dàqe	V	play tag
dàqe	V	be it in the dàqe game
dàtt	V	braid someone’s hair traditionally
de	PRPO	as for
de	ADV	really
dee	V	end
dee	V	be quiet
dee	N	silence
dee	N	death
deebal	N	giant
deekali	V	revive
deeki	V	revive
deele	V	have someone close to one die
deeloo	V	return
deelu	V	go back
deem	N	type of fish
deewi	V	go and die
deédeét	PRT	NEG
deégoo	V	agree on
def	V	do, put spend
def	V	be extremely; do some
defaat	V	repeat
defal	V	do for
defar	V	repair, make
defarlu	V	have something fixed
defe	V	believe a fact
dege	N	peanut butter
defukaay	N	container
dekka	N	village
dekkandoor	N	statement
dekki	V	come back from the dead
dekuwaay	N	residence
dell	IDEO	very
delloo	V	return something
dellu	V	return
dellu	V	shrink
dellu	V	get back together
dellu	V	born dead; die shortly after birth
dellusi	V	return
delusi	V	come back
dem	V	go
dem	V	go and, go to
dem	N	trip, journey
dend	V	be neighbors
dendoo	V	be near by
deñ	V	clear up; come untied; come out
deñ	V	be removed
deñca	V	keep
depaane	V	help someone out
depoose	V	drive
deppa	V	cover
der	N	hide; leather; prayer mat, image
deret	N	blood; blood relative
deret	V	be not in a good mood
des	V	remain
des	V	lack
Desàmbër	N	December
dese	V	still have, have less than
dese	V	be silly
desiṉ	N	painting
desit	N	leftover
detteel	V	fall on one’s bottom
detteelu	V	fall on one’s bottom
dewén	ADV	next year
dewën	ADV	next year
dex	N	river
déc	N	funeral
déeg	N	pool
déega	V	understand
déemba	ADV	yesterday
déédéét	NEG	no
déém	N	jujube
déém	N	jujube tree
déét	NEG	no! don’t!
dééy	V	whisper
dééy	N	thimble
dééyóó	V	talk confidentially
défrisé	V	have straightened hair
dég	N	thorn
dégaat	V	step on
dégg	V	know a language; hear
dégga	V	be true
dégga	N	truth
déggal	V	listen to, heed
déggadi	V	be stubborn
déggëdi	V	be stubborn
déggóó	V	agree
déglu	V	listen
dégmu	V	cup one's chin
démb	ADV	yesterday 
dénc	V	save; bury
dénga	V	be bent
dénka	V	entrust under care
dénku	V	promise, warn
déñkumpa	V	be nosy
déqi	V	harvest
dérém	N	unit of the Gambia currency
déy	N	thumb
dë	N	sole
dëbb	V	grind
dëdale	V	create confusion, separate between two parties
dëdd	V	leave
dëddu	V	turn one’s back on
dëddu	V	be out of circulation
dëféénu	V	lie on one’s stomach
dëgar	V	be hard
dëgër	V	be hard; be stubborn; be tight of a knot
dëgëraay	N	hardness
dëgërle	V	be hard, be stubborn
dëgg	B	step on someone’s foot
dëgg	N	truth
Dëggit!	INERJ	Very true!
dëj	V	set down; have a funeral for; put a child in time out
dëj	V	be fully developed but not ripe
dëj	N	funeral
dëju	V	be set down
dëkk	V	reside
dëkka	V	live
dëkkandoo	N	neighbor
dëkkéé	V	be characterized by, live with
dëkkëndóó	N	neighbor
dëkksi	V	come and live in
dëll	V	be thick
dëma	N	witch
dëmm	N	witch
dëmmóóyu	V	prop one’s head on one’s hand
dëng	V	be dishonest
dëngël	V	tilt, put on its side
dënk-kumpa	V	be nosy
dënn	N	chest
dënna	N	chest
dënu	N	thunder
dënu	V	thunder
dëñ	V	unravel, come untied
dëññ	N	nits
dëpp	V	turn something over
dëpp	V	turn around and go back
dëppu	V	be upside down, be inside out
dër	V	crush; run over
dër	V	stutter
dër	N	floor
dër-dërlu	V	pretend to stutter or stammer
dërëm	N	five fr. CFA
dëstëndiku	V	support oneself with one hand
dët	V	stammer
dëtt-mbér	N	pus
dëwën	N	next year
dëwlin	N	cooking oil
di	AUX	PROGR, HABIT
di	AUX	in order to
Dibéér	N	Sunday
dibi	N	roast lamb
dibitëri	N	store
dig	V	promise
digaale	V	agree upon
digal	V	recommend
dige	V	agree upon
digg	N	center
digga	ADV	in the middle
diggal	V	give advice
diggante	PRPO	in-between
diggënte	N	relationship
diggënte	N	distance
diggi-kër	N	courtyard
diggi-néeg	N	centre of the house
digi-ganaaw	N	back
diig	V	submerge in water
diigal	V	submerge in water
diiju	V	behave sulkily
diine	N	religion
diiné	N	religion
diir	N	period
diis	V	be heavy; be very pregnant
diis	NUM	ten
diisó	V	discuss
diisóó	V	discuss
diisóó	V	keep fit; have meeting
dija	ADJ	large
dijj	V	be too big
dakale	V	be moody
dikk	V	arrive
dikka	V	come
dikkël	V	suddenly be involved in
dikkële	V	be in a bad mood
dil	AUX	always.IMP
Dimaas	N	Sunday
dimbal	N	help
dimbale	V	help
dimbële	V	help
dimbëléé	V	lend
dimbëli	V	help
dimmali	V	help
dindééku	V	come apart
dindi	V	remove
dineñu	V	be:1PL.FUT
dineñu	V	be:3PL.FUT
dinga	V	be:2SG.FUT
dingeen	V	be:2PL.FUT
diṉi-diṉi	V	stamp
diṉool	N	querilla
dipi	V	uncover, turn face down
dipparñi	V	put right side up
dippi	V	put right side up
diri	V	drag
diryànke	N	relatively young woman with some experience 
disin	N	conception
dispañseer	N	medical center
distribuye	V	deal, distribute
dittax	N	type of fruit
diw	N	oil
diw	V	lubricate
diw	N	what's-his-name, what’s-her-name
diwingalam	N	shea butter, ghee
diwiñor	N	fat
diwliin	N	cooking oil
diwlin	N	cooking oil
diwtiir	N	palm oil
diwul	V	put grease on oneself
dṉor	V	beat
doc	N	rock
dof	V	be crazy
dof	N	crazy person
dofe	V	be stupid or strange
dofloo	V	not to act serious toward
dofloo	V	be in love with
dog	V	end fasting for the day, be exhausted, die
dog	N	piece
dog	V	cut
dog	V	cut oneself
dogal	V	decide, order
dogandu	V	obstruct to, cut across a road
dogat	V	cut into little pieces
doggali	V	close the eyes of a dead person
dogit	N	little piece
doj	N	rock
doktëër	N	doctor
doktoor	N	doctor
doktor	N	doctor
dolli	V	add more
domp	V	pinch
domp	N	gripping stomach
dompat	V	pinch
dompot	V	pinch
donja	N	cube
donkaasi	N	unification
donma	N	personality
donn	V	take after
donn	ADV	alone
donna	V	inherit
doo	V	2SG.FUT.HABIT.NEG
doo	V	not to be
doo	PRO	some
dooga 	V	have just started
doojoor	N	ankle
doole	N	power
doom	N	offspring
doom	N	doll; fruit; corn; key; pill; hard drugs; game piece
door	V	begin
doorati	V	begin again
dootul	V	be no longer
dootul	AUX	no longer
doq	N	back of the head
dot	N	stupid
dox	V	walk
doxaan	V	date, throw oneself at, court
doxaankat	N	someone who courts
Doxal	INTERJ	go away
doxandeem	N	stranger
doxandéem	N	waif
doxanéem	N	outsider
doxantu	V	stroll
doxat	V	fart
doxe	V	walk with
doxee	V	walk with, walk from
doxin	N	way of walking
doxloo	V	make someone walk
doxot	V	fart
doy	V	be enough
doyadi	V	be strange
doye	N	need for
doylu	V	be satisfied
doywaar	V	be terrible, be of great surprise
dóma	N	witch
dónj	N	lump
dóom	N	ashes
dóor	V	beat, strike
dóóm	N	ashes
dóómutaal	V	be grey
dóón	AUX	IMP.PST
dóór	V	hit
dóórlé	V	help someone hit
dóppa	V	turn back, cover
drwaa	N	right
dribëlé	V	dribble
du	V	not to be
du	PRT	NEG
du	AUX	IRR
du	V	be:3SG.NEG, be:3SG.NEG.FUT
duf	V	be fat
dugël	V	put inside; get someone into trouble
dugg	V	enter
dugg	V	be into
dugga	V	enter
duggal	N	slot
duggënte	V	be friends
duggi	V	go grocery shopping
duggo	V	shop in the market
duggoo	N	business
duggsi	V	come in
dugub	N	millet
duguj-dagac	V	be swaying the hips
dukat	V	lift
dukku	V	bribe
dul	V	never
duma	V	hit
duma	PRO	1SG.FUT.NEG, HABIT.NEG
dumë	PRO	1SG.FUT.NEG, HABIT.NEG
dun	N	island
dund	V	alive
dund	N	sustenance; life
dunda	V	be alive, enjoy
dundël	V	take care of
dundus	V	be fat
dungeen	PRO	2PL.FUT.NEG, HABIT.NEG
dunq	N	feather
dunxa	N	feather
duñu	PRO	1PL.FUT.NEG, HABIT.NEG
dur	V	hit
dur	V	be very drunk
duté	N	tea
duubël	N	two fr. CFA
duuf	V	be fat, have a good figure
duufal	V	fatten especially an animal
duul	N	excrement; lies
duul	V	tell lies
duul	V	defecate
duus	N	bathroom; wave
duy	V	get water
eb	V	load
ebal	V	send
eboo	INTERJ	no choice
ebu	V	be interested in, pack one's belongings	
edda	N	waiting period before a divorced woman can remarry
eggële	V	finish
egsameṉ	N	examination
egsi	V	arrive
elaastik	N	rubber band
eleew	N	student
Endu	N	East Indian
Enjeṉ	N	American Indian
eṉfermyeer	N	nurse
ekateku	V	be chipped
ekati	V	chip
ekspolose	V	explode
Eliman	N	Imam
em	V	be fit, careful
emadi	V	be restless
emale	V	measure
emale	V	make fit, make calm
en	V	head
en	N	luggage
endu	V	spend the day
enu	V	carry on the head
eñ	V	lift up, roll, turn
epons	N	sponge
esaans	N	petrol
esaanseer	N	gas station
esans	N	gasoline
esaṉsëri	N	gas station
esen	V	scratch
Esipt	N	Egypt
espageti	N	spaghetti
espees	N	type
espes	N	type
espoor	N	sports
estaad	N	stadium
estati	N	statue
estomaa	N	stomach
estuwaar	N	crime
et	N	log
etaas	N	floor, story
Ey	INTERJ	Hey!
ee	INTERJ	look out!, Hey!
Eebi	V	unload
eeda	V	advice
eedkat	N	adviser
Eega	V	reach
eel	N	shin
eeloo	V	deserve
eemba	V	be sane
eembadi	V	be insane
eendal	V	spend a day
eendu	V	spend the day
ees	V	be new
eesa-ees	V	be very new
eeta	V	carve
eeta	N	front yard
eew	V	tie
eewoo	V	wake up with
eewu	V	be awake
éeg	V	climb
éegali	V	complete
éegee	V	deliver a message
éemu	V	be devoted
éen	N	eye brow
éené	V	wish whole heartedly
ékip	N	team
ékkóól	N	European-style school
épéngël	N	hairpin
ééfar	N	pagan
ééga	V	arrive at
ëcc	V	spin
ëf	V	blow
ëfël	V	bring together, provoke
ëgg	N	rain that comes other than during the June-October rainy season
ëkati	V	lift
ëkk	N	stump
ëkka	N	bull
ëkka	N	stump, hectare
ëlbëti	V	turn over
ëllëg	N	tomorrow; future
ëllëk	N	tomorrow; future
ëmb	V	be pregnant
ëmb	V	bundle up
ëmb	N	pregnancy; bundle
ëna	V	be fermented, smell bad, be dirty
ënn	V	be slightly fermented and ripe-smelling; be smelly
ëñ	V	roll up
ëpp	V	be too much
ëpp	V	have more than
ëpp	V	be more than
ëppël	V	do too much; not to think about what one is doing
ër	N	dark spot on the skin
ër	V	wander around
ër	V	surround
ës	V	be tough
ëtt	N	courtyard
ëw	V	form a circle around
ëw	V	cover with leather
fa	CLT	there:NSUBJ
fa	ADV	where
faaca	V	burst
faale	V	pay attention
faar	N	rib
faaru	V	impress
faas	N	sideburns
faas	V	be inquisitive, be beard
faate	V	forget
faatu	V	die
faatu	N	name
fab	V	carry
fabu	V	pack up and go
fac	V	cure
fackat	N	doctor
faf	V	succeed in
fagarlu	V	try harder
fagas	V	brush off
fagasu	V	brush oneself off
faggu	V	think about
faj	V	cure, solve
fajkat	N	healer
fajar	N	dawn prayers;
fajar	N	sunrise
faju	V	go to the doctor, cure oneself
faju	V	be taken care of
faju	V	cure oneself
fajukaay	N	hospital
fajukaay	N	remedy
fakatalu	V	stumble
fakkastal	V	trip
fakkastalu	V	trip
fal	V	select
falaanel	N	flannel
fale	ADV	there
falu	V	be elected, germinate
fan	ADV	where
fan	N	day, life
fanaal	N	lantern boat
fanaan	V	spend the night
fanaanal	V	spend the night with
fande	V	go to bed without supper
fande	N	surname
fande	V	be late for something, be stranded
fanweer	NUM	Thirty
fanxa	V	prevent
fap	V	take
far	V	be thick; be on the same side
far	V	go over to, be on the side of
far	V	erase
far	N	boyfriend, suitor
faral	V	thicken; support
faral	AUX	usually
faramfàcc	V	explain
faramfàcce	V	explain to
Faraṉs	N	France
Faraṉse	N	French person; French language
farata	N	religious obligation
faraw	V	be impatient
farax-raxi	V	walk fastly
farin	N	white flour
fariñ	N	white flour
farlu	V	try harder
farlu	V	be dedicatedd
fas	V	tie;
fas	N	horse
fas	N	knot
fas	V	make a knot, est liquid food with the bear hand
fas	V	be inconsiderate
fase	V	get divorced
fas-fas	N	knot
fasoṉ	N	type
fasoo	N	porridge
fasoo	V	be prepared for
fat	v	take in
fat	ADV	very much
fat	V	lodge
fata	V	be georgeous
fata	V	patch, wean, leave alone, branch off
fataaya	N	type of fried pastry filled with meat
fatarñi	V	remove patching materials
fatt	V	fill in, patch, cover, block the cracks in
fatt	V	fill up, close up
fattu	V	have something in one’s eye
fatu	V	be sheltered, seclude oneself
fatukaay	N	shelter
faw	ADV	forever
faxa	V	remove with force
faxas	V	brush off
faxeeku	V	come from
fay	V	leave one’s husband
fay	V	pay; put out
fay	N	person's name
fayda	V	add value
fayyu	V	get revenge
fayyu	V	claim a debt from
fayyul	V	avenge a wrong against
fayyul	V	get back a debt for
fàcc	V	burst
fànq	V	prevent
fàṉṉ	V	show
fàṉṉaaral	V	show; be indiscreet
fàq	V	break
fàttali	V	remind
fàttaliku	V	remember
fàtte	V	forget
fàyda	N	personality
fàydaal	V	honor
fecc	V	dance
feccali	V	fill up
feccali	V	have some more food
fecci	V	untie
fee	ADV	there
feebar	V	be sick
feebar	N	disease
feec	V	be full
feecali	V	fill-up
feeci	V	unite
feelit	N	splinter
feelu	V	take over for
feelu	V	help in
feene	N	cream
feeñ	V	show; be found
feeñ	V	be found
feeñal	V	reveal
feeñal	V	teethe
feeñu	V	appear to
feer	N	iron
fees	V	be full, be fixed
fees	V	skin
feesal	V	fill
feet	N	celebration
feeta	V	sting, crack, shoot an arrow
feex	V	be airy
fekk	V	find
fekk	V	happen that
fekka	V	meet
fekke	V	be there for
fekkee	V	witness
fekksi	V	come and find
fel	N	flea
fell	V	be chipped
fen	V	lie
fen	V	pass on
fendeeku	V	be matured
feneen	ADV	somewhere else
fenn	ADV	somewhere, nowhere, anywhere
fendi	V	be dried out
fenk	V	rise
fenkat	V	liar
fent	V	make up, invent
fer	V	be partly dry, dry up
fer	N	beaded or perfumed belt worn by women under the clothes; weaning period
fer	ADV	completely
feral	V	wean
fere	V	expend
ferej	V	mince
ferenkulaay	N	sitting Indian or tailor style
ferenkulaayu	V	sit Indian style, sit tailor style
fermëtiir	N	zipper
ferñent	N	spark
fes	V	be bright
fet	V	bump against
fetal	V	shoot
fetal	V	gun
fete	V	scrub
fetel	V	shoot
fetel	N	gun
fett	V	shoot an arrow
fett	N	arrow
fettax	V	jump; gush out; sputter
fexe	V	try
fey	V	leave one’s husband
fey	V	turn off, pay
feyeeku	V	receive one's pay, revenge
feyi	N	smother
feyu	V	revenge
feyyu	V	get revenge
fécca	N	dance
fécca	V	dance
féccakat	N	dancer
fédageéw	V	be too much in gathering
féela	V	chip
féepa	ADV	anywhere
féetéeku	V	fall hard
féewi-féwi	V	jump in confused manner
féexlu	V	take rest in an airy place
Féey	V	swim
féété	V	be located facing
féétéé	V	be located
féétél	V	position in
féétélé	V	position in
féétéléél	V	position in for
Fééwëriyé	N	February
fééx	V	be fresh; be free of burdens or obligations; be feeling better
fééxlu	V	get fresh air
fééy	V	swim
fééykat	N	swimmer
fég	V	finish one’s task or chores
fégël	V	finish one’s turn
félé	DEM	there
fépp	CNJ	wherever
féq	V	rise
fë	CLT	therethere:NSUBJ
fë	ADV	where
fëgël	V	finish
fëgg	V	knock
fëgg	V	knock on, shake out
fël	V	hit by accident with one’s foot
fëlé	ADV	there
fëll	V	show through
fënëx	V	be worm-eaten, be very old or worn-looking
fëq	V	make a big hole
fëq	V	have a big hole
fëqle	V	eat a lot
fër	V	have indigestion
fës	V	be bright
fi	ADV	here
fi	ADV	where
fici	V	grain a fabric
fiddi	V	run fast
fiddiwol	N	string
fiftin	N	one fr. CFA
fii	ADV	somewhere here
fii	N	sow
fiil	N	cable
fiile	V	drive fast
fiim	N	film
fiip	N	the sound of blowing your nose
fiir	V	be jealous
fiir	V	hit
fiir	V	be hurt in an automobile accident
fiire	V	be jealous of
fiiriir	V	fry
fiirir	V	fry
fiix	be liberal
fiixlu	V	take a dest in an airy environment
filé	ADV	somewhere here
film	N	movie
findi	V	blacken
findi	N	cereal
fippu	V	revolt; have determination
fipu	V	retaliate, rebel
firdu	N	fula, tribe, type of fula found in the fulla stretch
fireeku	V	be undo braids, be broad
firééku	V	come unbraided
fir-firi	V	rrun about
firi	V	open a bundle and spread out; undo; explain, translate
firikat	N	translator
firil	V	explain to, translate for
firindé	N	translation, puzzle
firiñtiku	V	unravel
firisidéér	N	refrigerator
fit	N	courage
fita	V	sweep, shoot with arrows
fitaxu	V	write
fitna	N	worry
fitnë	N	trouble, hard work
fitt	N	bow and arrow
fiw	N	form of a stomach up set
fo	V	play
fo	CNJ	only, or, whether, if
fo	Q
fo	N	must
fo	PPOS	to, till, expect, up to
fo	ADV	much, so
fob	V	carry, take, pick up
fobeere	V	mop
fobeere	N	mopping job
fobeerekaay	N	mop
foe	V	play with, not to be serious about
foee	V	joke with
fog	N	must
fog	V	estimate
fogga	V	knock, dust
fokat	N	jester
folli	V	drop
folli	V	lose power
fomm	V	postpone
fompa	V	clean
fomp	V	wipe, mop, dust
fompu	V	dry oneself
fompukaay	N	cleaning instrument
fonde	N	porridge
fonk	V	really love
fonka	V	respect
fontoo	V	tease; not to act seriously
fontu	V	goof off
foo	Q	where:2SG.SUBJ
foo	V	miss
foo	V	be very dirty, fail to fire
foo	ADV	staying, telling
foof	V	winnow
foofu	ADV	there, at that very place
foog	V	estimate
fooge	V	expect in
foogul	V	not to think that
fooj	V	forge, pretend
fooli	V	demote
fooma	V	cancel
foor	V	be important
fooxa	V	pluck
fop	V	take
fóla	V	slip unexpectedly
fóón	V	kiss, smell
fóq	V	crack a bone
foqle	ADV	there
for	V	find
foraatu	V	be picking up things
forog	N	frock
foromaas	N	cheese
forot	V	be fraud
forox	V	smell sour, rotten, sweaty; be astringent 
foroxal	V	be make become sour
forse	V	force
fos	N	sewer
fosi	V	come and play
fot	V	be choking, have had some food go down the wrong way
fottarsu	V	snap one’s fingers
foto	N	photograph, film
foto	V	take a photograph of, take a picture of
fowandoo	V	play together
fowi	V	go and play
fowukaay	N	toy
foxoj	N	sprain
foxoju	V	have a sprain
foye	V	play with
foyi	V	go and play
fómpu	V	wipe
fónax	V	be dirty, be rotten
fóon	V	kiss, smell
fóxale	V	be greedy
fóón	V	kiss; smell
fóót	V	wash
fóót	V	present traditional gifts to a new mother
fóóti	V	go and wash
fóóti	V	go and wash; go and present traditional gifts to
fóótkat	N	kaundry person
fóótsi	V	come and wash
fóótsi	V	come and wash; come and present traditional gifts to
foq	V	crack a bone; stretch oneself
foyee	V	joke with
föt	V	choke
frijidéér	N	refrigerator
fu	PRO	where:SUBJ
fu	Pro	where:OBJ
fu	ADV.somewhere
fu	N	place
fu	ADV	anywhere that
fudda	V	iron, throw, stretch
fuddan	N	henna
fuddanu	V	apply henna on palm, foot to show femininity
fuddën	N	henna
fuddën	V	paint or dye
fuddënu	V	have one’s hands or feet painted with henna
fuddu	V	stretch oneself
fufu	N	cassava dough
fukk	NUM	ten
fukka	NUM	ten
fukkeel	N	tenth
fukkéél	N	tenth one
fukkéélu	N	tenth
fulaar	N	scarf
fulééku	V	be flayed
fuli	N	flay
fulla	N	dignity
fullë	N	character
funki	V	be swollen
funkki	V	have gained weight
furi	V	loose value
furno	N	coal pot, habachi
furnó	N	hibachi, open charcoal grill
furset	N	fork
fusal	V	fart
futeéku	V	be undressed
futból	N	soccer; soccer ball
futi	V	undress
futt	V	be blistered
futta	N	blister
futt-futt	N	blister
fuuf	ANV	very much
fuuf	V	blow air
fuur	V	roast
fuuy	V	be proud
fuxi	V	pull off from
fuy	Q	3SG:where
fuy	V	massage
ga	DET	the, REM.SG.that
gaa	N	people
gaacaayoo	V	be equipped
gaace	V	shame
gaadaay	V	desert
gaadam	N	spleen
gaaf	V	be ill-fated, be forbidding
gaafa	N	traditional style of pouch or purse worn around the neck
gaaganti	V	rectify, prompt
gaaka	V	stain
gaaka-gaaka	N	stain
gaal	N	boat
gaalaj	N	amulet
gaalankoo	N	difficulty
gaamo	N	inter-rival relationship, muslim feast
gaana	N	leprosy
gaana	V	have leprosy
Gaana	N	Ghana
gaanar	N	Mauritania
gaanaay	N	weapon, among
gaanga	V	be optimistic, forebode
gaanuwaay	N	place to urinate
gaañ	V	hurt
gaañe	V	hurt intentionally
gaañ-gaañ	N	wound
gaañu	V	get hurt; die
gaapa	V	wait for, siege
gaar	V	repair
gaar	N	train station
gaaraas	N	bus station; garage
gaaral	V	say, insinuate something unpleasant about, hit
gaarw	V	park, garage
gaaruwaale	V	drop hints
gaaruwaale	V	drop hints about
gaas	N	stove
gaas	V	wet
gaata	V	be short
gaaw	V	be fast; be quick to spread a story
gaaw	V	fast
gaaw	ADV	quickly
gaawantu	V	hurry
Gaawu	N	Saturday
gaddu	V	carry on one's shoulder
gafaka	N	traditional style of pouch or purse
gag	V	forget what one has been talking about
gaja	V	cut, scratch
gajj	N	small scrape made by a claw or nail
gak	V	stutter
gala	V	vomit
galaas	N	ice
galan	V	cross
galaṉ	V	tilt, put diagonally
galaxndeku	V	rinse the mouth
gal-gal	V	encourage
gale	DEM	that
gallax	N	clot, curd
gallaxndiku	V	rinse out one’s mouth
gallox	N	clot, curd
gamba	N	ground
gam-gami	V	doze
gan	N	visitor
ganaar	N	chicken
ganaar	V	be timid
ganaaw	PRPO	behind
ganaawkër	N	back-yard
ganale	V	make someone feel welcome
gancax	N	young sprout or shoot
ganda	N	penis
gandax	N	waves
gane	V	visit
ganeji	V	go and visit
ganesi	V	come and visit
gannaaw	N	back
gannaawam	ADV	in ones's absence
gantu	V	refuse
gañaxu	V	make a face
gañe	V	win
gaññ	V	grimace
gaññaxu	N	grimace
gaññaxu	V	make faces
gaṉlgeṉ	N	bandit group
gapareku	V	squat
gapparu	V	sit with one’s knees bent and one’s legs to the side
gar	N	type of millet porridge 
gar	V	make gar
gar	V	gather one's harvest
garaaw	V	be serious
garab	N	tree; medicine
garanti	V	guarantee
garangaal	N	type of big ngaal beetle
garde	V	guard
gardekat	N	guard
gargamboose	N	nettle
garmi	N	noble person
garolemaa	N	spare, protection
gas	V	dig
gase	V	wager
gaskat	N	digger
gasu	N	shovel
gasukaay	N	shovel
gat	N	buttocks
gat	INTERJ	happiness at someone else’s misfortune
gatal	V	excrete
gatandu	V	go and meet
gatandu	V	block
gato	V	peanut cake
gatul	V	get to hell
gaynde	N	lion, hero
gàcce	N	shame
gàdd	N	band; abundance
gàddaay	V	go into exile
gàddam	N	spleen
gàddu	V	carry on one’s shoulder
gàgganti	V	prompt
gàkk	V	be spotted; make a mistake
gàkk	N	spot; mistake
gàkk-gàkk	N	spot
Gàmbi	N	the Gambia
Gàmmu	N	the Prophet’s Birthday celebration
Gànnaar	N	Mauritania
gànnaay	N	weapon
gàntu	V	refuse
gàññ	V	be abundant
gàpp	N	limit
gàtt	V	be short
gàttaay	N	shortness
gàttagàtt	V	be very short
gàttandu	V	get ready for
gedd	V	give up; go on a hunger strike
geéna	V	go out
geénee	V	take out
geéw	N	circle
gelu	V	miss
gena	V	be more than
genawalla	N	half
genso	N	underwear
genta	V	dream, migrate
geño	N	a mads belt
ger	V	bribe
gee	N	evening prayers
gee	PRO	that
geeda	V	reject
geej	N	dried fish
geen	N	tail
geenji	V	be broody
geer	N	war
geestu	V	revise
geet	V	put on a diet
geeta	N	herd
geetu	V	go on a diet
geewe	N	evening prayers
geex	V	burp
gejj	N	dried fish
gel	N	girlfriend
gelu	V	miss
gellwaar	N	prince
gena	V	be more than
genawalla	N	half
genso	N	underwear
genta	V	dream, migrate
geño	N	drawstring
ger	V	bribe
gerees	N	fat
gereew	N	strike
gereew	V	go on strike
gerew	V	strike
gerte	N	peanut
gerte-lakka	N	grilled peanuts
gerte-saaf	N	grilled peanuts
gerte-tubaab	N	Indian almond
gerte-xaaran	N	raw peanuts
gestu	V	look over one’s shoulder
getën	V	bother, annoy
gete-bambara	N	Mailan peanut
gete-baxal	N	boiled peanuts
gédda	V	respond rudely
géemeñ	N	mouth
géer	V	be noble
gémentu	V	be sleepy
gén	V	surpass
géna	N	pipe
génaatle	V	discriminate
génee	V	remove
génékat	V	stubborn
gét	V	fish
géten	V	be disturbed, border
gétné	V	be disturbing
géwël	N	griot, praise singers, oral history
gééj	N	ocean
Géér	N	member of the highest Senegalese caste
gééw	N	circle
gééwal	V	form a circle around
gémmiñ	N	mouth; words
gémmiñu	V	talk admiringly about someone and thus provoke a bad fate
génn	V	leave; date; show up
génn	V	appear on
génnal	V	date
génné	V	take out
gént	V	dream
gént	N	dream; area with abandoned houses
gét	V	fish
géti	V	go and fish
gétt	N	herd; sheep pen
géwël	N	oral historian
gë 	DET	the; that
gëf	V	snatch a bit of sleep
gëj	V	have been somewhere some time ago, not have been somewhere for a while
gëj	V	have done something some time ago, not to have done something for a while
gëjëf	V	be soften by soaking
gëlé	PRO	that
gëléém	N	camel; tall person
gëlem	V	be uncertain of one's way, be lost
gëlem	N	camel
gëm	V	believe
gëm	N	belief
gëmm	V	close one’s eyes
gëmmentu	V	be sleepy
gën	V	be better
gën	V	be more
gënël	V	be better for
gënël	V	prefer
gënn	N	grinder, mortar
gënna	N	mortar
gërëm	V	thank
gërgéepa	N	home wears
gërmande	V	express gratitude
gësëm	V	shake, intimidate
gëstu	V	look into
gët	N	eyes
gi	DET	the; that
gii	PRO	this
giif	V	calm down; subside
giiñ	V	grimace
giiñ	N	grimace
giiru-dunda	N	duration of life
giiru-dundam	N	duration of one's life
giix	V	belch
gilé	PRO	this
gilisé	V	slide
gimmi	V	open one’s eyes
Giné	N	Guinea
Giné-Konaakiri	N	Guinea-Conakary
ginnaaw	N	back
giñ	V	swear
giriya	N	wire grauze
gis	V	consult
gisaane	V	foretell the future
gisaan-kat	N	future teller
gisandoo	V	see together
gisante	V	see each other
gisee	V	see each other
gisé	V	consult each other
gis-gis	N	view
gisi	V	go and see
gisul	V	not to be able to see
gisul	V	not to see
godoroṉ	V	tar
gof	V	snatch a bit of sleep
goj	N	well rope
golo	N	monkey
gom	N	starch
gomadi	V	disbelief
gomantu	V	be sleepy
gome	V	starch
gomee	V	have something unexpected
gonga	N	local fragrant made form bamboo bed
gongo	N	perfumed powder, or beads made from it
gont	V	go to work in the afternoon
gontu	V	go to work in the afternoon
goṉ	N	baboon
goór	N	man
goór-goórlu	V	make an effort
goór-jugeén	V	be womanish
gopp	N	type of long-handled spade
gor	N	honorable person
gor	V	cut down
gore	V	be honorable
gore	V	be content, be honest
goro	N	relative or friend of one’s spouse; in-law
goros	N	large wrapped cone of sugar
Gosaas	N	Gossas
gosi	N	rice dish with flavorings and buttermilk
gosi	V	make gosi
gowaatër	V	have a goiter
goob	V	harvest
goog	V	be precocious
googu	PRO	that
góm	V	believe in
góm	N	belief
góma	V	close one's eyes
góne	N	child
góom	N	cut, wound
góób	V	cut grass, harvest grain
góóm	V	have an infected sore
góóm	N	infected sore
góór	N	male
góóré	V	be masculine
góór-góórlu	V	try hard
góór-jigéén	V	male homosexual
góórtu	V	look for a man
gu	N	big house
gu	PRO	REL
gudda	V	be long
gudd	V	be tall
guddaay	N	length
gudee	V	be late at night
guddéé	ADV	late
guddi	N	night
guddi	V	be late
gumbaal	V	blindfold; blind, cause blindness
gumbë	V	be blind
gumbë	N	blind person
gumbo	V	be blind
gumbo	N	blind person
gumpa	V	wash clothes
gunduur	N	beetle
gune	N	child
guné	N	child
gungeé	V	convey
gungé	V	accompany
gunóór	N	insect
gunuur	N	beetle
guppa	V	wash clothes
gurment	N	protestant
gurmet	N	charm bracelet
Gurmet	N	Christian
guró	N	kola nut
guru	N	kola nut
guus	V	be damp
gutta	N	jug
guu	V	climax
guu	N	taste, orgasm
guuj	V	hold water in one's mouth
guus	V	be humid
guux	V	take a sip
guux	N	take a swallow,gulp
guwernamaa	N	government
guy	N	baobab tree
guy	V	be very
guyaab	N	guava
guyaav	N	guava
haar	V	wait for, siege
i	DET	some
i	PRO	2
Ibliis	N	Devil
ijj	V	spell
ijji	V	read syllable by syllable
ijjil	V	spell
ileer	N	hoe
ilif	V	head
illa	N	curtircura
illeer	N	hoe
imaam	N	imam
inchalaaxu	INTERJ	if its pleases God
inchAllah	INTERJ	God willing
indaale	V	bring with one
inddé	N	steamer
indé	N	steamer
indi	V	bring
indiji	V	go to fetch
Indil!	V	Bring it to me!
iniwersité	N	university
iñaan	V	be jealous
iñaane	V	be jealous
Iraak	N	Iraq
isi	V	bring
isin	N	factory
islaam	N	Islam
it	ADV	too, also
itam	ADV	too, also
ite	V	be interest
ii	INTERJ	surprise
iiñ	V	be tired of something
iir	V	cover, obscure
ja	N	forehead
ja	DET	the, that
jaabal	V	pick a lock, fiddle with
jaabante	V	go back and forth
jaada	V	make a quick stop
jaadu	V	be fair to be right
jaaf	N	pubic hair
jaahgoro	N	sickness
jaaka	N	mosque
jaakaarloo	PRPO	opposite
jaal	N	space in the mouth where a tooth is missing
jaal	V	have a space in one’s mouth from having lost a tooth
jaala	V	cross
jaale	V	present one’s condolences, express one’s sympathy
jaam	N	slave, prisoner of war; dishonorable person; cousin who calls one’s father nijaay
jaaleekaay	N	crossing point
jaam	N	slave
jaama	N	peace
jaamba	N	opium, marijuana
jaambaat	V	complain
jaambaatkan	N	complainer
jaambu	V	be desert
jaambuur	V	be calm
jaamu	V	help with a ceremony knowing one will be rewarded
jaamu	V	worship
jaan	N	snake
jaandi	V	respond to someone rudely
jaani	V	respond to someone rudely
jaappa	V	perform ablution, hold
jaappale	V	help
jaappandeku	V	hold unto
jaappoo	V	be united
jaar	V	pass by
jaar	N	palm rat
jaaraama	INTER	thank you
jaaro	N	ring
jaaru	V	warm oneself near a fire or heater
jaaru	N	ring
jaaru-baaram	N	finger-ring
jaaru-noppa	N	ear-ring
jaas	V	arrive suddenly
jaasi	N	hatchet
jaasi	N	cutlass
jaasiir	V	be baren
jaasir	V	be sterile
jaat	N	coffin
jaawale	V	mix up
jaawaleel	V	confuse
jaawaatle	V	confuse
jaaxal	V	concern; surprise
jaaxaal	V	doubt
jaaxle	V	be worried
jaay	V	sell; spend; tell on
jaay	V	sell to
jaaykat	N	seller
jaba	N	market
jabar	N	wife
jabartu	V	help to bring about a desired event in the future
jabet	N	diabetes
jaboot	V	have a large family
jadd	V	be stiff
jadda	V	make a quick stop
jaf	V	be in flames
jafal	V	light
jafandiku	V	hold on
jafandu	V	hold on
jafandu	V	make use of something
jafe	V	be expensive; be difficult
jafe-jafe	N	complication
jafeñ	V	be scarce
jafte	V	be overcome by craving for food
jafte	N	sickness at early stage of pregnancy
jafuur	V	make people know of person's witch craft
jag	V	have improved
jag	V	be suitable
jagadi	V	be in bad shape
jagal	V	improve
jagle	V	dedicate
jal	V	put in piles
jal	N	pile
jale	PRO	 that
jall	V	hire
jaloore	N	misdeed
jaloore	N	achievement, great deal
jam	V	stab; tattoo
jam	N	shoot
jam	V	stone at someone, pierce
jamaale	N	rivals
jamaano	N	period
jamaatle	N	male rival
jamano	N	period
jamb	V	mix with the hands
jamba	N	opium
jamba	N	mix
jamba	N	name
jambaar	N	brave man
jambaaryaa	N	courageous man
jambajóob	N	peacock
jambur	N	peasant
jam-jam	V	cut
jamkat	N	tapper
jàmm	N	peace
jamp	V	be urgent
jampa	V	be important
jamu	V	be tattooed on the lower lip
janax	N	mouse
janaaba	N	bath
janaase	N	cemetery
janeer	V	daydream
janfaa	V	disappoint
janfaa	N	betrayal
janfaa	V	betray
janga	V	learn
jangakat	N	student
jangale	V	teach
jangalekate	N	teacher
jangi	V	go to school
jangoro	N	disease
jangu	N	church, school
jangukaay	N	school
jankalaar	N	black scorpion
jankat	N	grafter
janoo	V	be across from each other
janq	N	virgin
jant	N	sun
janta	N	sun
janxa	N	girl
janxatu	V	puberty for girls
jaṉ	N	graft
jar	V	be famous
jar	V	sell well
jar	V	cost
jar	N	type of seed; medicinal tea
jara	N	bracelet made with beads
Jaraaf	N	representative of the King of Cayor and Jolof
jarbaat	N	nephew; niece
jargoñ	N	spider
jariñ	N	helpfulness
jariñoo	V	use
jartu	N	comb
jas	V	cutdown
jasig	N	crocodile
jasit	N	crocodile
jat	V	hypnotize by repeating spells in a secret language
jatkat	N	hypnotizer
jataay	N	meeting
jawu	N	remote place
jax	V	be plentiful
jaxaay	N	eagle
jaxas	V	mix
jaxase	V	mix up
jaxasekat	N	trouble shooter
jaxasoo	V	be mixed up; be all kinds
jaxasu	V	be already mixed
jaxat	N	squirrel
jaxato	N	type of bitter vegetable
jaxatu	N	type of bitter vegetable, bitter tomatoes
jaxaay	N	eagle
jàdd	V	turn, make a quick stop on the way
jàkk	N	neighborhood mosque
jàkka	N	neighborhood mosque
jàkkaarloo	V	face each other
jàll	V	cross
jàllaabi	N	Arab-style robe
jàllale	V	help someone cross
jàlle	V	take
jàmb	N	sugar cane
jàmbaar	N	brave man
jàmbaar	N	term of address used between men
jàmbat	V	complain
jàmbu	V	betray
jàmbur	N	human being; nice person
jàmm	N	peace
jàng	V	study
jàng	V	study at
jàng	N	studies
jàng	N	religious gathering
jàngal	V	teach
jàngale	V	teach
jàngalekat	N	teacher
jàngaleji	V	go and teach
jàngalesi	V	come and teach
jàngee	V	study at
jàngi	V	go to school
jàngkat	N	student
jàngoro	N	illness
jàngsi	V	come to school
jàngu	N	Koranic school
jàngukaay	N	school
jànni	V	put down
jànq	V	leave before sunset
jàpp	V	wash; be busy
jàpp	V	hold; tag
jàppukaay	N	handle; potholder
jàq	V	be anxious, be uneasy
jee	DET	that
jeebaanu	N	spied
jeebaanukat	N	spy
jeebalu	V	put oneself under a spril
jaabanu	N	spy
jeeg	V	not to have the money to be able to make a sacrifice at Tabaski
jeeg	N	relatively young woman with some experience
jeegal	V	forgive
jeegël	V	forgive
jeego	N	step, footprint
jeeki	V	be still
jeex	V	be expired; lose weight
jeexël	V	finish
jeexël	V	graduate
jeexle	V	be out of, have no more
Jeébale	V	handover a wife
jeégi	V	walk
jeégi	N	foot print
jeéku	V	accomplish a task, be well-off
jeém	V	try
jeéri	V	cool off
jege	V	be close
jegeñ	V	be close
jegesi	V	approach
jekk	V	be attractive
jekkali	V	finish off
jekku	V	be prepared for
jell	V	pass something over a wall
jell	V	be crosseyed
jell	N	fall
jelloo	V	be neighbors
jébbël	V	take a bride to her husband, after the wedding ceremony
jébbëli	V	have one’s wedding night
jébbëlu	V	follow the teachings of a religious leader
jébbëlu	V	join a religious sect
jéeg	ADV	already
jéela	N	crossed eyes
jéém	V	try
jééx	V	dig around for
jéggi	V	surpass
jéggi	V	take very big steps
jéneer	N	shaft of light coming through a crack
jéng	V	tie an animal by the back legs
jéppi	V	hate
jéqi	V	stir 
jéréjëf	N	thanks
jéri	V	pour hot liquid or laax from one container to another to cool it
jë	N	forehead
jë	DET	the; that
jëf	N	action
jëfëndiku	V	serve oneself; use
jëfin	N	way of doing things
jëf-jëf	N	accomplishment
jëflante	N	reciprocal relationship
jëkar	N	husband
jëkër	N	husband
jëkk	V	come first
jëkk	V	arrive before
jëkk	V	to V first
jëkka	V	be first
jëkkante	V	try to get there first
jëkkantu	V	try to get there first
jëkkër	N	husband
jël	N	take; steal
jëlé	DET	that
jëli	V	go and take
jëli	V	understand
jëlkat	N	thief
jëlsi	V	come and take
jëm	V	head to
jëmbat	V	plant
jëmbët	V	plant
jëmm	N	imposing appearance
jëmma	N	status
jën	N	fish
jënd	V	buy; bribe
jënda	V	buy
jëndël	V	buy for
jëndi	V	go and buy
jëndsi	V	come and buy
jënga	V	tie an animal's two legs
jëngu	V	risk, give up
jëppéét	V	burst into flames; burst in
jërëjëf	INTER	thank you
jëriñ	N	importance
jësit	N	crocodile, jasit munut
jëw	V	gossip
jëwaate	V	gossip
ji	V	plant
ji	DET	the; that
jib	N	light spot on the skin
jib	V	make a sound
jiba	V	be lucky
jig	V	work for
jigéen	N	woman
jigéén	N	woman
jigééné	V	be elegant
jigën	N	hump
jii	DET	this
jii	V	descend, ejaculate, decline
jiiñ	V	accuse of being
jiit	N	scorpion
jiital	V	put first, choose as a leader; have on clothing underneath one’s outer garments
jiital	N	underwear
jiité	V	lead
jiitu	V	be ahead of
jikko	N	mood
jilé	DET	this
jinax	N	mouse
jine	N	spirit
jinjar	N	ginger beer
jinjeer	N	ginger root
jinkoo	V	doze
jinkoo	N	slumbering
jinné	N	supernatural being
jip	V	ring
jip	N	ring
jis	N	name of fish
Jiwaalo	N	Joal
jiwëndóó	V	plant together
jiwi	V	go and plant
jiwu	N	seed
jiyi	V	go and plant
jodd	V	be stiff
joge	V	be close
joggati	V	surpass
joggi	V	step on foot
jolli	V	get louder
Jolof	N	Djolof, a region of Senegal
Jolof-Jolof	N	native of Djolof
jolu	V	drink from a bottle
jolu	Q	how much, how many
jom	N	self-esteem
jomlu	V	be allergic to, be ashamed of
jommi	V	be bewitched
jonga	V	circumcise
jonkon	N	squat
jonkon	V	squat
joogare	N	hump
jooju	DET	that
jooka	V	knuckle
Joolaa	N	Diola person, person from the Diola ethnic group of Senegal; Diola language
joolooli	N	bell
joomal	V	frighten
Joop	N	Diop
joow	V	be backbite, gossip
joowar	V	shout at someone
jooy	V	cry
jooyajooy	V	cry and cry
jooyantu	V	cry off and on, or not seriously
jooyloo	V	make someone cry
jooytu	V	nag, complain
jot	V	be the time
jot	V	fit; receive; afflict; happen to
jot	V	be stricken with
jot	V	finally get to
jot	V	reach
jot	V	get
jotaay	N	gathering
jote	V	have something going on between one another
jotee	V	be in conflict with
jottëli	V	pass on
jottëlikat	N	someone who passes something on
jottali	V	pass on
jottalikat	N	someone who passes something on
jox	V	give to; deal
joxe	V	deal, contribute, give out
joxle	V	contribute to a gift
joxoñ	V	point at
jóg	V	stand up
jógé	V	come from
jóggee	V	come from
jómb	V	be inappropriate behavior for
jómmi	V	be bewitched
jómmil	V	bewitch
jóngal	V	circumcize
jóngu	V	be circumcized
jónkan	V	squat
jónkon	V	squat
jóqqarbi	V	squat put one’s finger on someone’s forehead and push his head back
ju	DET	any N that
jub	V	be straight; be honest
jub	N	straighten
juba	ADV	at the tip, at the opix
jubadi	V	be dishonest
jubadi	V	be in straight forward
jubal	V	go straight
jubb	N	tail of hair left growing near the front of an otherwise shaven head; braid wrapped tightly with thread
jubbanti	V	straighten out
jubbënti	V	straighten out
jubëdi	V	be dishonest
jubël	V	go straight
jublu	N	face, head
jublu	V	be opposite
juboo	V	be in harmonious relation
juboo	V	be born at
jubóó	V	be agree
juddoowaale	V	be born with
judóó	V	be born in
juddu	V	be born
judduwaale	V	be born with
judu	V	be born
jula	N	trader, person's name
juli	N	pray
julit	N	muslim
julli	V	pray
julli	N	prayer
jullikaata	N	dragon fly
jullikaay	N	prayer
Jullit	N	Muslim
julliwul	V	be having a menstrual period, have just had a baby
jumaa	N	central mosque
jumaa	PRO	which, who
jumbax	N	navel
jumbuj	N	swollen eyelid
jumbux	N	navel
juné	NUM	thousant
juṉ-juṉ	N	large drum
junne	NUM	thousand
junne	N	2.5000 fr. CFA
junni	NUM	thousand
junni	N	2.5000 fr. CFA
juṉ-juṉ	N	large drum
juṉxóób	N	crab
jup	V	approach
jupsi	V	approach
jur	V	be the parent of
jur	N	herd of cattle
jur	V	deliver, create
jurgóótu	V	stick a feather in one’s ear and idly twirl it around 
juróóm	NUM	five
juróóméél	NUM	fifth one
juróóméélu	NUM	fifth
juum	V	be wrong
juumé	V	be mistaken
juumte	N	mistake
juutal	V	upside down, cause to bend
juutu	V	bend over with one’s back to
juuwé	V	mislead
juuyóó	V	miss one another
juwé	V	mislead
jhàndarm	N	gendarme
jhilé	N	sweater vest
jhipp	N	skirt; half slip
ka	DET	the; that
ka	PRO	the one that
ka	POSTP	to
Kaaba	N	Muslim holy place in Mecca
kaacciri	N	whip
kaaci	N	lie
kaacikat	N	liar
kaad	V	be stiff
kaadar	N	frame
kaadi	N	judge
kaadu	N	speech, word
kaaf	N	cage
kaala	N	turban
kaalawu	V	have one’s head covered with a scarf or shawl
Kaamil	N	the Koran
kaani	N	hot pepper
kaani	V	season with hot pepper
kaaṉ	N	skull; learned person
kaar	N	bus
kaare	N	square
kaarité	N	type of vegetable oil
kaas	V	moisten
kaas	V	get mad
kaas	N	cup
Kaasamaas	N	Casamance, region of southern Senegal
kaata	V	pinch ear between one’s bent index finger and thumbnail, as a punishment
kaata	N	ear pinching
kaay	INTERJ	come!, come on!
kaay	V	come and V 
kaay	V	come and let’s V!
Kaayoor	N	Cayor, a province in Senegal
kabine	N	cabinet, cupboard, closet, bathroom
kabine	V	have a bowel movement
kaf	N	joke
kaf	V	tease, joke
kafe	N	coffee
Kajoor	N	Cayor, a province in Senegal
kaju	V	be in a corner
kak	ADV	very
kak	N	sound made by a breaking
kal	N	hole, inter-tribal realtionship
kal	V	prevent
kalaame	V	complain
kalaas	N	class in a school; style
kalaase	V	rate
kalaate	V	be wrecked
kalaate	N	deal been spoiled
kalaksoṉ	N	car horn
kale	V	block; trip up
kale	V	have a mental block
kale	DET	that
kale	PRO	that one
kal-kali	V	shake
kal-kali	V	be loose
kalkil	N	arithmetic
kalkil	V	calculate
kalle	V	be stocked
kallentaan	ADV	a tiny bit
kalpe	N	wallet
kama	N	toilet
kamaj	V	put out
kamba	N	hollow
Kamërun	N	Cameroon
kamisol	N	camisole
kamisool	N	robe
kamp	N	the two cows tamers use for plowing
kan	Q	who:SG
kan	N	hole
kanaara	N	duck
kanam	N	face
kanasu	V	by crazy
kandaama	V	climb a tree
kandaama	N	gourd
kanja	N	okra
kankuraṉ	N	mandinka masquerade
kañ	Q	when
kaña	N	rat
kañaan	N	jealousy
kañaan	V	be jealous
kar	V	block way
karaas	N	dandruff
karaas	V	have dandruff
karaas-karaas	V	to make a scraping or shuffling sound with one's shoes
karaas-karaasi	V	scrape or shuffle one’s feet
karaw	N	hair
karaw	N	small balls of millet flour
karayoṉ	N	pencil
kardigaṉ	N	ardigan sweater
kari	N	curry
kar-kari	V	tremble
karmat	V	miss eating the meal served at sunrise during Ramadan
karnaat	N	pad lock
karne	N	notebook
karo	N	diamonds; tile
karo	N	tile floor
karoot	N	carrot
karot	N	carrot
kart	N	playing card
kart	V	play cards
karto	N	playing cards
kartye	N	district
karwaas	N	strap
karwaase	V	hit someone with a strap
karwaat	N	necktie
karwaatu	V	have a tie on
kasag	N	ceremony with singing and dancing honoring newly circumcised boys
kasag	V	participate in a kasag ceremony
kasag	N	songs
kasara	V	be no good
kasara	N	not good person
kasaara	V	destroy
kasaara	V	be spilled beyond repair, go in vain
kasiloor	N	light cooking pan with a handle
kasinoo	N	casino
kaso	N	prison
kaso	V	jail
kastiloor	N	pan
kasu	N	cashew
kat	PRT	really
kata	V	have a sexual intercourse
kataa	V	be troublesome
kataa	N	trouble
katolik	N	Christian
Katólik	N	Christian
katt	V	have sex with
kattan	N	power
kattante	V	have sex together
kaw	N	top, lap, shoulders
kawar	N	hair
kawar	N	small balls of millet flour
kawas	N	sock
kawas	N	hair
kawdiir	N	cooking pot
kawe	V	be high 
kaw-kaw	N	unsophisticated person
Kawlak	N	Kaolack
kay	PRT	really
kayaṉ	V	be lanky
kayit	N	sheet of paper, certificate, visa
kayitloo	V	make fun of
kàbbar	V	raise one’s hands on either side of one’s head to begin one’s prayers
kàcc	V	lie
kàcc	N	buttermilk
kàcciri	N	whip
kàcciri	V	whip
kàdd	N	acacia tree or fruit
kàddiir	N	cooking pot
kàddu	N	speech
kàggu	N	library
kàllaama	N	language
kàmb	N	ditch
kàmp	N	short fat loaf of bread
kànj	N	okra
kànja	N	okra
Kànkuraṉ	N	Mandinka and Diola dancer
Kànkuraṉ	N	Mandinka and Diola dance
kànnaar	N	padlock
kàttan	N	power
kee	DET	that
kee	PRO	that one
keeku	V	cackle
keem	N	burnt rice at the bottom of the cooking pots
keepar	N	shade
kees	N	box, chest
Kees	N	Thies
keén	V	wish for
kekk	N	hard dirt
kel	N	type of tree with very hard wood
kemb	V	be shelled
kem-kattan	V	be the most one can do
ken	PRO	nobody
keneen	PRO	someone else
keneen	N	next person
kenkeliba	N	traditional Senegalese tea
kenkiliba	N	traditional Senegalese tea
kenn	PRO	no one, someone, anyone
kenn	ADV	alone
keṉṉ	V	ring
kepp	V	catch in a door; pin
keppa	V	pin
keppa	N	pegs
keppa	PRO	anyone
keppaar	N	shadow
keppu	N	pegs
ker	N	shade
kere	N	chalk
kereem	N	ice cream; face cream
Kereyoolor 	N	Creole person or language
keriñ	N	charcoal
kerog	N	that day
keroog	ADV	recently
kersa	N	politeness
Kes!	INTERJ	Shoo!
kese	ADV	alone
kesseṉ-kesseṉ	N	child’s noisemaker
ketandi	N	steamed meat & fish
kew	N	white clay
kew	V	be calm
kewel	V	deer
keww	V	observe things with absorbed attention
kex-kexi	V	laugh
kélé	N	that person
képp	PRO	whoever
kéwël	N	antelope
kéyit	N	sheet of paper, certificate, visa
kë	DET	the; that
kë	PRO	the one that
këc	V	ignore
këcc	ADV	very
këccax	N	fish, smoked fish split into pieces
këdd	V	hit
këër	N	hearts
këf	N	thing
këlé	DET	that
këlé	PRO	that one
këll	N	container either made from a calabash or made from wood in the shape of a calabash
këll	V	be very full
këlla	N	small jar
këmëx	N	fist
këmëx	V	punch
kënu	V	collide
kënu	N	cannon
këṉ	ADV	very
këpp	V	knock over
këpp	V	turn over; fall down
kër	N	home; family
këriñ	N	charcoal
kër-kër	N	struggle
kër-këri	V	struggle, be overwhelmed
kës	V	search around for food
këyit	N	sheet of paper, certificate, visa
këyitloo	V	make fun of
këyitlóó	V	impose too many requirements on
ki	DET	the; that
ki	PRO	the one that
ki	V	send
kii	DET	this
kii	PRO	this one
kilé	DET	this
kilé	PRO	this one
kilifa	N	head of a household or family; diginitary;
kilifë	N	head of a household or family; diginitary;
kiliyaan	N	customer
kilo	N	kilogramm
kiló	N	kilogramm
kilomeetër	N	kilometer
kilomet	N	kilometer
kiri-geej	N	seagull
kiri-kisi	V	find out
klaksoṉ	N	car horn
ko	CLT	3SG.OBJ
ko	V	say
ko	ADV	like, as
ko	ADV	of course
kobooy	N	cowboy
koddaay	N	style of wrapping a sër
Koddiwaar	N	Ivory Coast
koddi waar	N	Ivory Coast
kofal	N	buttocks
kof-kofi	V	tremble from the cold
kojomtu	V	eat, pay eating
kok-kok	V	to make the sound of high heels
Kokaakolaa	N	Coca-Cola
kokumber	N	cucumber
koli-koli	V	try
kol	N	shawl; glue
koll	N	stomach
kollërë	N	alliance, gratefulness
Kolobaan	N	Coloban
kolooj	V	deliberately put one’s finger in someone’s eye, gouge someone’s eye
kolooj	V	delude
koloor	N	color
kolu	V	put on a shawl
kom	PRPO	like, such as
komaase	V	begin
komiseer	N	police chief
komka	CNJ	because, as long as
kom-kom	N	economy
kompañi	N	business
kompin	N	company
kon	CNJ	then, in that case 
Konaakiri	N	Conakry
konsumßel	N	constable
kontaan	V	be happy
kontaar	V	disagreed to counter
kontar	V	disagree with
konte	V	count; pay attention to
konte	N	surname
kontine	V	continue
kontinuwaar	N	counter
koñ	N	street, corner
koñe	V	be impede
koṉ	N	catfish
koo	PRO	who, whom
kooca	V	play love, fondle
koocax	V	play love, fondle
koog	N	calabash, spoon like small dipper
kook	N	calabash spoon
kooko	N	coconut
kooku	DET	that
kooku	PRO	that one
koola	N	belly
koóni	N	fruit
koom-koom	N	economy
kóopin	N	Turkey
Koor	N	Ramadan
koor	N	corn on the foot
koor	V	fast
kooraa	N	21-stringed Senegalese musical instrument
kooy	N	penis
koparatiif	N	cooperative
kopati	V	make a hole
kopp	N	cup
kóppa	V	be capsized
koppe	N	cooperative
kopperaatif	N	cooperative
Kor	N	title followed by a man’s name, used to refer to his wife or girlfriend
kor	INTERJ	word used to call a horse or a donkey
Kori	N	holiday marking the end of Ramadan
Korite	N	holiday marking the end of Ramadan
kor-kor!	INTERJ	word used to call a horse or a donkey
kor-koral	V	use one’s food or money carefully
koroose	V	crochet
koroose	N	safety
koroose	V	cross one’s legs; latch, hook
korne	V	blow a horn
korsaas	N	blouse
kort	V	cast a spell on
kort	N	spell
korte	V	spell
kostiim	N	suit
kostim	N	suit
kostimu	V	have a suit on
kot	ADV	alone
koti	N	crab
koti-koti	V	stand behind a child and scratch his ears lightly while saying
kot-koti	V	shiver with cold
kotom	V	be wrinkled of ears
kott	ADV	alone
kott	V	embrace
kow	N	top; lap shoulders
kowe	V	be high
kow-kow	N	unsophisticated person
kóf	V	snatch
kóllëré	N	relationship of mutual respect
kóndról	V	corn row hair 
kóndról	N	corn row hairstyle
kóndólu	V	have one’s hair corn rowed
kravaach	V	hit with a strap
kravaat	N	necktie
ku	Q	who.SG.SUBJ
ku	Q	who.SG.OBJ
ku	PRO	REL.SG
ku	PRO	someone
kubeer	N	lid, cover
kuddal	N	erection
kuddu	N	spoon
kuf	INTERJ	Go away!
kuk	ADV	very
kukk	ADV	very
kulëër	N	color
kuli	N	syphilis
kuloor	N	color
kumaase	V	begin
kumpa	N	secret
kumpa	N	curiosity
kumpa	V	be inquisitive, be mystery
kumpo	N	masquerade
ku-nekka	PRO	everyone, everybody
kupe	N	football
kuppakala	N	type of large crab
kuppe	V	cut the cards
kuraṉ	N	electricity, current
kurpeñ	N	fist
kurpeñ	V	hit with one’s fist
kurus	N	prayer beads
kuuraṉ	N	electricity
kus	N	buttocks
kus	V	drive
kus-kus	N	couscous
kuur	N	pestle
kuus	N	dwarf
kuy	N	ram
kuy	N	cow, sheep
la	POSTP	at, from, through, by
la	PRO	3SG.OBJ.FOC
la	PRO	2.OBJ
laa	PRO	1SG.NSUBJ.FOC
laa	N	sheath, side
laa	V	be:1SG
laa	V	believe, accuse, lie down
laab	V	clean
laabe	N	father
laabir	V	be compassionate
laabiir	V	be generous
laabu	V	clean oneself after defecation
laaf	N	wing
laafa	N	knitted wool hat
laago	N	handicap
laaj	V	ask
laaj	N	garlic
laajte	V	ask a question
laajte	V	ask about 
laajte	N	question
laaka	V	speak
laaka	N	language
laakakat	N	foreigner, speaker
laal	V	touch, push, have sex
laalal	V	touch for
laali	V	clear
laalo	N	sap of the baobab tree, powder
laamarsees	N	cake
laamaan	N	landowner
laamba	N	wrestling
laamba	V	touch, feel
laambatu	V	grope
laameñ	N	tongue
laamisoo	V	flirt
laanga	V	confront
laaṉa-laṉaral	V	open
laap	V	clean someone after defecation
laapa	V	be skinny
laas	N	eye mucus 
laase	N	shoelace
laase	V	tie
laase	V	have a laxative effect on
laax	N	millet porridge mixed with sweetened buttermilk; chemical mixture used to lighten the skin
Laaxira	N	remote place where people go when they die, or the end of the earth
Laayeen	N	Senegalese Muslim sect
laayi	N	dew
Laaylaa!	INTERJ	Oh my god!
lab	V	drown
lafañ	N	person with a limp
lafañ	V	limp
lagac	N	person with a limp
laja	V	impede
lajj	V	fail
lakk	V	burn
lakk	V	deep fry
lakka	V	burn
lakkal	V	disturb
lakka-lakka	N	burn
lakkale	V	be annoying
lakke	V	burn
lal	N	bed
lal	V	make a bed
lal	V	set the table or floor
lale	DET	 that
laltu	N	tablecloth
lam	N	bracelet
lamaan	N	land owner
lamba	V	be unwanted
lampa	N	electricity
lamset	N	razor blade
lan	Q	what
lang	V	hang down; to show; to come along
langa	V	dangle
langal	N	locket
lanka	V	be refuse
lanu	PRO	1SG.NSUBJ.FOC
lañar	V	be opened
lañset	N	razor blade
lañu	PRO	1SG.NSUBJ.FOC
lan	V	be staying in, hanging out in
laṉ	N	question
laṉspyeer	N	slingshot
lap	V	drown
laploo	V	drown
las	N	crooked legs
las	V	be abundant
laspeer	N	slingshot
late	V	be always coming to
law	ADV	very
law	V	spread
lawbe	N	woodworker
Lawbe	N	member of the Senegalese woodworkers caste
lax	V	be wilted
laxaañi	V	search
laxaarci	V	search
laxal	N	hangover
laxas	V	wrap
laxasu	V	wrap thread around one’s hair; be tangled
lay	V	sift; give as an explanation
lay	V	give conflicting explanations
layoo	V	be judged
layu	V	straw winnowing basket
layu	N	sieve
layukaay	N	sieve
làbbe	N	priest, minister
làkk	V	speak a language other than ordinary conversational Wolof; speak unintelligibly
làkk	V	speak
làkk	N	language
làkkat	N	speaker of a tonal African language
làlli	V	clear the table, unmake a bed; run away
làlli	V	take off the bed
làmb	V	feel
làmb	V	fight
làmb	N	wrestling match
làmbaatu	V	fondle casually; talk to or question without revealing how little one knows, trying to suggest that one knows more than one does
làmbdaj	N	material
làmmiñ	N	tongue; words
làmp	N	light
làngaa-buri	V	play a hiding game in which one player hides a knotted piece of material for others to find, and the one who finds it uses it to hit the rest
lànk	V	refuse
lànkar	N	ink
làntinoor	N	funnel
làpp	V	hit
làqarci	V	unwrap
leb	V	borrow
lebal	V	sell on credit
lebéer	N	hippopotamus
Lebu	N	Lebou person, tribe
lebu-lantaṉ	V	be in trouble
lee	DET	that
leeb	N	story
leegi	ADV	now
leegi	ADV	soon
leel	V	be bald
lee-lee	ADV	sometimes
leeli	V	flay
leemi	V	unfold
leen	CLT	2PL.OBJ
leen	CLT	3PL.OBJ
leen	PRO	2.IMP
leen	PRO	3PL.OBJ
leen	N	wool
leer	V	be bright
leer	V	be straight
leeray	N	brightness
leeral	V	be prim, clarify
leerandu	V	follow
lees	N	length
leetar	N	letter
leeyal	V	feed
leéb	V	tell a story
leégi	ADV	now
legoos	N	printed cotton material
leket	N	calabash
lekk	V	eat
lekk	V	see through, possess, and finally cause to sicken and die; exhaust financially
lekk	N	food
lekka	N	food
lekkaan	V	eat around
lekkalekk	V	eat and eat
lekkantu	V	snack
lekke	V	eat with
lekket	N	calabash
lekkin	N	way of eating
lel	V	please
lem	N	honey
lem	V	fold
lemmi	V	unfold
lempo	N	tax
leneen	PRO	something else
lenn	PRO	something
lenna	PRO	something
lenqali	V	rinse off
leñu	PRO	1PL, 3PL
lep	V	borrow
leple	V	sell on credit; lend
leppa	PRO	anything, everything
leru	V	walk alongside of a wall or fence
les	V	sharpen, peel
lew	ADV	very
lew	N	honesty
lewat	V	be shy
lewet	V	be bland
lex	N	cheek
léébal	V	tell a traditional story for
léébël	V	tell a traditional story for
Léébóón	INTER opening remark
lééj	V	be difficult, V be a troublemaker
léému	V	stay a prayer
léému	V	say a prayer for
léép	V	tell a traditional story
léép	N	traditional story
légét	N	scar
léjum	N	vegetable
lékkóól	N	European-style school
lépp	PRO	whatever, everything
létt	N	braid
létt	N	carefully braided braid
létta	V	be braid
léttkat	N	braider
léttu	V	have braided hair; braid one’s hair
lë	DET	the; that
lë	PRO	that
lë	AUX	3SG.NSUBJ.FOC
lë	CLT	2SG.OBJ
lëc	V	be tangled
lëf	N	thing
lëf	N	vagina
lëg	N	hare
lëj	V	be entangle
lëjal	V	entangle
lëju	V	be entangled
lëjum	N	vegetables
lëk	N	rabbit; hare
lël	N	circumcision
lëlé	DET	that
lëlé	PRO	that one
lëlu	V	seclude oneself; act antisocial
lëmës	V	wrap; bandage
lënd	N	spider web
lëndëm	V	be dark
lëndëm	N	darkness
lëng	V	put one’s arm around shoulder
lëng	N	type of tropical fruit
lënga	V	hug
lëngóó	V	put arms around each other’s shoulders
lënu	PRO	1SG.NSUBJ.FOC
lënxa	ADV	trully, really
lëñu	PRO	1SG.NSUBJ.FOC
lëppalëpp	N	butterfly
lëpp-lëpp	N	butterfly
lëwal	N	ataya
li	DET	the; that
li	PRO	that 
Libane	N	Lebanese person
Liberyaa	N	Liberia
licin	N	eagle
ligeey	N	profession
ligeeykat	N	worker
legeéy	V	work
liggééy	V	work
liggééy	V	have prayers said or charms made against one
liggééy	N	profession
liggééyaan	V	work at odd jobs
liggééyéé	V	work at
liggééyël	V	work for
liggéékat	N	worker
liggééyukaay	N	workplace
lii	DET	this
lii	PRO	this one
lii	V	shave
liibar	N	pound
liibër	N	half kilo
liibër	V	be liberated
liifantu	V	learn the alphabet
liifantu	N	alphabet
liifàntu	N	alphabet
liiñ	N	clothesline
liiñ	N	line
liir	N	baby
liir	V	read
liiral	V	read
liitar	N	liter
lijjanti	V	untangle; solve
likoloñ	N	perfume
lilé	DET	this
lilé	PRO	this one
lim	V	enumerate
liminaat	N	soda
limonaat	N	soda
limoṉ	N	lemon
limoṉ	N	lemon, lime tree
limuunaat	N	soda
limyeer	N	light
Lingeer	N	Queen, Prince
lingéer	N	Princess
liñoṉ	N	onion
liṉom	N	lemon
Lippóón	INTER	audience’s response
Lislaam	N	Islam
litkoloñ	N	perfume
liw	V	be cold
log	V	keep in the mouth
lojte	V	solicit
lokarbi	V	lake out
lomas	V	wrap
lomosuwaay	N	wrapper
lonka	V	hook, hang
loṉ-loṉ	V	be long
loo	PRO	what
loo	V	stand
loo	N	height, contest
loo	N	firewood
looco	N	canoe
lool	ADV	too, so very
loolu	DET	that
loos	N	neck
loota	V	stood
loota	V	be tired
looy	N	owl
lopet	V	kick
lopitaan	N	hospital
loppitaal	N	hospital
loqati	V	take some of a pasty substance on one’s finger
lor	V	get in trouble
lor	V	disappoint, jeopardize
lore	N	jeopardy
loru	V	be in trouble
loru	V	be disappointed
lox	V	shiver tremble
loxati	V	pull out
loxo	N	hand; arm; sleeve; hand in cards; amount; share
lóóbu	V	be difficult
lóriyé	N	bay leaf
lu	Q	what.SUBJ
lu	Q	what.OBJ
lu	DEM	something
lu	DET	one
lu	DET	that, anything that
lu	N	dumb
luci	V	grimace
lujum	N	vegetable
lumpa	V	eat
Lundi	N	Monday
lu-nekka	PRO	everything
lunet	N	glasses
lunka	V	be crooked
luppa	N	tight
luqati	V	take some of a pasty substance on one’s finger
lutax	Q	why
luubu	V	be rude
luugu	V	be rude
luux-luuxi	V	wriggle
luxus	V	do magic
luxus	V	make something appear by magic
luxus	N	magic
luxuskat	N	magician
luy	Q	what is
ma	DET	the; that
ma	PRO	1SG.OBJ
maa	PRO	1SG
maa	V	touch, stir, copulate, behave
maab	V	braid
maaba	V	collapse, cave
maada	N	sour sap
maafe	N	Senegalese dish
maagal	V	celebrate
maaget	V	be old
maaget	N	elderly person
maal	N	drake, boot
maalekumsalaam	INTERJ	peace on to you
Maalekumsalaam	INTERJ	peace back to you
Maali	N	Mali
maalo	N	rice
maam	N	grandparent; ancestor; older person
Maam	N	first name used before the name of a much older person for whom a child is named – this may be a legal first name
Maam	N	title used respectfully before a much older person’s last name
maamaat	N	great-grandparent, blood relative of great-grandparent’s generation
maanaa	V	be important
maandarga	N	sign
maangi	N	mangroves
maaṉ	V	be:1SG
maap	V	braid hair traditionally
maas	N	age-mate
maas	N	generation
maas	V	give a shock to
maas	V	be afraid
maas	N	sleeve
maas	V	sleeve
maasa	V	be sorry
maasaloo	V	be leveled
maasale	V	smooth out, rub in
maase	V	be smooth; be about the same age
maata	N	sting
Maawluud	N	the Prophet’s Birthday celebration
maaxaama	N	status
maay	V	disappear
macc	V	suck
mace	N	matches
madam	N	Miss
Madam	N	Mrs.
mag	N	older sibling; older person
mag	V	be older; be big
mag	V	grow
magget	N	old woman
makka	N	mecca
malaaka	N	angel
malaan	N	large cloth, sheet
malaatar	N	mulatto
male	DET	 that
mallar	N	sarong
man	PRO	1SG.SUBJ
man	PRO	1SG.OBJ
mandi	V	be drunk
mandu	N	man's name
mandu	V	be polite
maneebar	N	worker
mangi	V	be:1SG
mangoro	N	mango
maniiwu	N	semen
manke	N	shortage
manke	V	remain, lack
mankoo	N	shortage, united
mankoo	N	mangrove
manq	N	balloon
manq	V	siphon
mantaas	N	drum
maño	N	manure
mar	V	be thirsty
mar	V	lick
maraaj	N	wall
marabu	N	marabout; spiritual advisor
maral	N	drought
marax	N	dusk
mariñeer	N	smock-like blouse
mariyaas	N	marriage; name of a card game
marke	N	score
marlu	V	mark
marmaraan	N	worm
Marok	N	Morocco
marokeṉ	N	kus-kus marokeṉ
Mars	N	March
marse	N	market
marto	N	hammer
marto	V	hammer
mas	V	express sorrow
masin	N	machine; sewing machine
maslaa	V	have an arrangement 
masoṉ	N	bricklayer, mason
mat	V	be complete
mat	V	make
mat	V	be adequate
mat	V	be old enough to be N
mat	N	mathematics
mat	V	labour
mata	N	fire wood
matlaa	N	European-style mattress
matmisel	N	miss
Matmisel	N	Miss
matt	N	firewood
matta	N	bed bugs
matta	V	bite
mattu	V	be bear
matu	V	be in labor
matul	V	be silly
matul	V	be inadequate as a
max	N	termite
maxe	V	be eaten by termites and ready to crumble; be old, in need of repair
maxtume	N	small pouch containing something to protect one against evil
may	V	let
maye	V	allow
maye	V	give away as gift
maye	N	gift
mayenees	N	mayonnaise
mayonees	N	mayonnaise
màgg	V	grow up
màggat	V	be older, be old 
màggat	N	old person
màgget	N	old person
Màkk	N	Mecca
Màkka	N	Mecca
màkkarooni	N	macaroni
màndërin	N	mandarin orange
mandarin	N	mandarin orange tree
Màndeng	N	Mandinka person; Madinka language
Màndeṉ	N	Mandinka person; Madinka language
màndi	V	be drunk
màndikat	N	drunk person
mànga	AUX	1SG.REM.IPFV
mànga	V	be:1SG.LOC
màngi	AUX	1SG.IPFV
màngi	V	be:1SG.LOC
màngo	N	mango
mànke	V	be scarce
mànke	V	be out of
mànt	N	peppermint
Màssa	INTERJ	I’m sorry!, That’s too bad!
màtt	V	bite
màtt	N	bedbug
màttat	V	keep biting
meeb	N	bait
meeb	V	bait, handle, carry
meego	N	butt
meen	N	sap
meena	V	be usual
meeña	N	sprout
meep	N	bait
meer	N	woman who behaves fairly conservatively; mother
meer	N	mayor
Meer	N	nickname for an older woman
Meer	N	title used before the last name of an older woman
meer	V	be dizzy
mees	V	braid hair in individuals
mees	V	be skinny
meesees	N	flea
meesu	V	have one’s hair braided in individuals
meetar	N	teacher
meetar	N	meter
meetit	N	sorrow
meew	N	milk
meéda	V	be faint, be in coma
meéda	N	dead animal
meéngoo	V	agree, be similar
meéti	V	be painful
mekka	V	be quiet
mel	V	be like
melax	V	be shiny
melax	V	be lightning
melax	N	lightning
melaxal	N	lightening
melaxal	V	shine
melentaan	N	ant
meles	V	disappear
melo	N	complexion
melo	N	behavior
melokaan	N	behavior, symptoms
meññ	V	set fruit, have fruit come out
mer	V	be angry
mer	N	anger
mere	V	be angry
merfe	V	be lack of front of tooth
metis	N	person who is half black, half white
metti	V	be difficult; hurt
mettit	N	pain
mettitlu	V	brood
mey	V	give
mey	V	allow
meye	V	tell jokes or stories
meye	V	give away
meye	N	offering
meye	V	get married
méccé	N	occupation
médd	N	dead animal
méece	N	profession
Méé	N	May
më	DET	the; that
më	CLT	1SG.OBJ
mëlé	DET	that
mën	V	be able to do
mënin	N	ability
mës	V	have ever
mët	V	be complete
mët	V	make
mët	V	be adequate
mët	V	be old enough to be N
mi	DET	the; that
michwi	N	 roast lamb
midi	N	noon
mii	DET	this
miikar	V	be quiet
miin	V	be familiar with
miinéél	N	familiarity
miir	V	be dizzy
miir	N	dizziness
miir	N	wall 
miis	V	be familiar with
mikro	N	microphone
milé	DET	this
mindaan	N	maid
minise	N	carpenter
minisé	N	carpenter
minista	N	minister
ministër	N	government minister
minit	N	minute
minwi	N	midnight
miskar	V	be quiet
miskar	N	a person who keeps a low profile
miskiin	N	poor person
miswi	N	roast lamb
mobilet	N	motor bike
moca	V	suck
mocaat	V	suck bones
mokk	V	be pounded; be memorized
mokkal	V	be prepared
monaam	N	sarong
montar	N	wristwatch
montër	N	wristwatch
moo	PRO	3SG.SUBJ.FOC
Moo!	INTERJ	Look at you!, Would you look at that!
Mooka	V	be well
mool	N	fisherman
moolu	V	implicate
moom	PRO	3SG.SUBJ
moom	PRO	3SG.OBJ
moom	V	possess; dominate
moom	V	belong to
moomu	DET	that
mooñ	V	prepare Senegalese-style couscous
Moosi	N	Mossi person; Mossi language
mootax	CNJ	that's why
móol	N	fisherman
moppa	V	smother
Moritani	N	Mauritania
morom	N	age group
moroom	N	age-mate
mos	V	taste
mos	V	have ever
moto	N	vehicle
mottali	V	complete
moxoñ	V	crumble
moy	V	miss a goal
moy	V	miss; cheat on
moy	V	be missed
moyal	V	tilt
moytu	V	be careful
moytu	V	avoid
móróg	V	be round
mótó	N	motorcycle
mu	PRO	REL.SG
mu	DET	any N that
mu	PRO	3SG
mucc	V	survive
mucca	V	give birth
mucca	V	be save
muj	N	end
muje	N	end
muje	V	be last
mujeél	N	the end of
mujeél	V	be the last
muji	N	the end of
mujj	V	come last
mujj	V	end up
mujjé	V	be the last
mujjé	V	end up
muk	ADV	never
mukk	ADV	never
mukus	V	be quiet
mun 	V	be able to do
mun	Vbe better than
mungéé	AUX	3SG.LOC
mungë	PRO	3SG.REM.IPFV
mungë	AUX	be:3SG.LOC
mungëlé	PRO	3SG.SUBJ
mungi	PRO	3SG.IPFV
mungi	AUX	be:3SG.LOC
mungii	AUX	be:3SG.LOC
mun-mun	N	capability
muñ	V	be patient
Murit	N	Mouride-member of a Senegalese Muslim sect
mus	V	have ever
mus	ADV	ever
musal	V	save from trouble
musal	V	save
musalkat	N	savior
musé	N	sir
Musé	N	man’s first name
Musé	N	Mr.
musël	V	protect
musibë	N	misfortune
muslaay	N	charm
musóor	N	head dress
musóór	N	head scarf, or wrapped headdress
musóóru	V	have on a scarf or other head covering
mustaas	N	mustache
muswaar	N	handkerchief
mut	V	be enough
mutali	V	complete
mutard	N	mustard
mutu-mutu	N	tiny insect
muuma	V	be mute
muumë	V	be mute
muumë-muumëlu	V	pretend that one can’t talk
muumu	N	dumb
muuñ	V	hold back a laugh
muur	V	cover
muuraay	N	style or way of wrapping or covering one’s head
muuril	V	uncover
muuru	V	have one’s head covered
muuru	V	cover
muus	N	cat
muus	INTERJ	calling a cat
muus	V	be wise
muusal	V	steam
muuse	V	cheat,take advantage
muut	V	eat
muuti	N	anus
muut-muuti	V	be restless
muxa	V	fall on one's face
muxat	N	fool	
muy	N	makes
Muyyéén!	INTERJ	Look at you!, Would you look at that!
mbaa	V	hope:1SG
mbaal	N	net
mbaal	V	catch
mbaal	V	catch in a net
mbaam	N	pig; donkey
mbaam-aala	N	bush pig
mbaame	V	be rough; not to feel pain
mbaam-sëf	N	donkey
mbaapa	N	water lily
mbaapa	N	a plate with big leaves
mbaar	N	shelter
mbaatu	N	small calabash
mbaaxa	N	tripe
mbaga	N	shoulder
mbagg	N	shoulder
mbal	N	naughty child
mballax	N	style of Senegalese music
mbalit	N	garbage; garbage can
mbalka	N	trough, water tank
mbalu	V	masturbate
mbañ	N	enemy
mbar	N	sheath
mbar	V	skid
mbarateko	V	skid
mbarateku	V	skid
mbarr	N	skid
mbas	V	dodge
mbas	V	throw someone down 
mbaxal	N	dish made with rice, fish, and vegetables
mbaxana	N	hat
mbaxane	N	hat
mbay	N	harvest
mbàjj	N	blanket
mbàttu	N	small calabash, large wooden spoon
mbedd	N	outside
mbedda	N	street, road
mbej	V	slap
mbelemtaan	N	ant
mbetteel 	N	surprise
mbey	N	harvest, cultivation
mbéc	V	slap
mbéc	N	slap
mbég	N	happiness
mbégte	N	happiness
mbér	N	pus
mbëc	V	give a shock to
mbëc	V	get a shock
mbëgg	N	desire, love
mbëggéél	N	desire, love
mbëkk	V	bump into
mbëlit	N	garbage; garbage can
mbër	N	wrestler, achiever
mbëtt	N	type of large lizard
mbiif	N	big elephant ears
mbiip	N	toy whistle
mbilib	N	whistle
mbind	N	writing
mbindaan	N	servant
mbindééf	N	unusual person
mbir	N	event, situation
mbiskit	N	crackers
mbokk	N	relative; good friend
mbolde	N	big stick
mbonaat	N	turtle
mbooloo	N	assembly
mboosoor	N	memory
mbootaay	N	association
mboq	N	corn
mbota	V	crawl under
mbote	N	lamb
mbott	N	frog
mbóót	N	cockroach
mbóóyo	N	harmattan
mbubu	N	boubou
mbubb	N	boubou
mbubba	N	dress
mbuggal	N	irritate
mbuggéel	N	liking, love
mburu	N	bread
mbuum	N	type of leaf used in cere mbuum, dish
mbuuru	N	bread
mbuus	N	plastic bag, container
na	PRO	3SG.NEUT.PFV
na	PRO	3SG.SBJV
na	PRO	3SG.FUT
naa	PRO	1SG.NEUT.PFV
naa	PRO	1SG.SBJV
naa	PRO	1SG.FUT
naac	N	sun
naac	V	be sunny; be late
naaf	V	piling
naafeq	N	liar
naafeq	V	be an imposter
naafila	N	prayer used after the gee prayer during Ramadan
naag	N	enclosure
naaje	V	late
naajo	N	squash
naam!	PRT	yes
naan	V	drink
naan	V	drink
naan	V	be safe, be home free 
naan	V	say.CONT
naa-naa	N	mint
naano	N	pipe
naanu	N	pipe
Naar	N	Mauritanian; Arab
naarugóór	N	Thoroughbred
naat	V	wealthy
naatànge	N	prosperity
naaw	V	fly
naawal	V	fly
naax	V	be senile
Nabi	N	the Prophet Mohammed
nac	V	squeeze
nafa	N	traditional pouch or purse worn around the neck
nafar	V	study for a test
nafar	V	study
nafeet	V	open wide
nak	Q	and X ?, how about X?
nag	N	cow; beef
najaay	N	mother's brother, uncle, aunt's husband; husband
naka	Q	how
nàkk	N 	rice ball rolled in sugar
nakk-nakkal	V	hesitate when answering
nal	V	squeeze
nale	ADV	that way
namm	V	miss
nàmp	V	suck
nàmpal	V	breastfeed
nammaliku	V	catch up with each other
nammeel	N	nostalgia
nan	Q	how
nangu	V	take back
nangu	V	take it
nangul	V	take it from
nanu	PRO	1PL.NEUT.PFV
nañu	PRO	1PL.NEUT.PFV
nañu	PRO	3PL.NEUT.PFV
nañu	PRO	1PL.FUT
nañu	PRO	3PL.FUT
napp	V	fish
napp	V	catch; dominate
nappaate	V	try to act tough or threatening
nappe	PRO	1PL.FUT
nappi	V	go and fish
nappkat	N	fisherman
naqadi	V	be bitter
nar	V	lie
nar	V	intend to
nas	V	thread; borrow
nataal	N	picture
natt	V	measure;contribute
natt	N	contribution
nawet	N	rainy season
nax	V	kid; cheat; pacify
naxaate	V	fool around
nay	V	be stingy with money
nay	N	stinginess
nàcc	V	bleed; spend money
nàkk	N	millet or rice ball rolled in sugar, distributed as an act of charity
nàkkal	V	distribute nàkk on behalf of
nàmp	V	suck; spend time with one’s mother
nàmpal	V	nurse
nànd	V	understand
nàndal	N	laxative; sedative
nàngam	N	a certain amount
nàññ	IDEO	very
ne	REL	that
ne	V	say that
ne	PRPO	like
nee	V	say that
nee	ADV	that way
neex	V	be delicious; be nice; be favorable; be attractive to the opposite sex
neex	V	be pleasing to
neex	V	like
neex	V	be easy to V 
neexal	V	reward; try to make up with after a disagreement
neexal	N	reward
neexle	V	be lucky; have one’s food be delicious
nekk	V	be located in
nekk	V	be, become
nekkandi	V	be
nekki	V	become, go and become
nekkin	N	situation
nelaw	V	sleep; die
nelawaan	N	part of a crab, believed to cause sleepiness when eaten
nelawantu	V	pretend to be sleepy
nelaw-nelawlu	V	pretend to be sleepy
nemmeeku	V	recognize
nen	V	lay an egg; have something too heavy on one
nen	V	lay
nen	N	egg
nene	N	little baby
neneen	ADV	another way
netetu	N	strong-smelling flavoring made from uul seeds
nettali	V	report
netuwayaas	N	dry cleaner’s; cleaning
new	N	type of fruit
newwi	V	be swollen
néég	N	room
nééw	V	be little
nééw	N	corpse
nég 	V	wait fornë
neg	PRO	3SG.NEUT.PFV
në	PRO	3SG.SBJV
në	PRO	3SG.FUT
nëbb	V	protect
nëbbëtu	V	hide
nëbbu	V	hide
nëbël	V	make rot; to soak in oil
nëë	N	bow
nëëf	N	nine
nëlé	ADV	that way
nëp	V	be rotten; have a strong smell
nëpp	V	allow to ferment
nëpp-nëppël	V	conceal
nëq	N	lower abdomen
nëx	V	be dirty
nëxit	N	scum
ni	ADV	how
ni	PRPO	like
nii	ADV	this way
niir	N	cloud
niit	V	look closely at; light up
niital	V	light up for
nijaay	N	uncle; husband
nilé	ADV	this way
niloṉ	N	nylon
Nimsaat	N	Nimzat district of Dakar
niróó	V	look alike
niróól	V	be like
Niseer	N	Niger
Niseryaa	N	Nigeria
nit	N	person
nité	V	be sensible
niw	N	cream
ngeen	PRO	2PL.SBJV
ngё	PRO	2SG.SBJV
nobeel	N	love
nokki	V	breathe noisily
noo	Q	how.2SG.SUBJ
noon	N	enemy
noonu	ADV	that way
noor	N	dry season
noos	V	do all right
noos	N	party
nooxoor	N	child of a male dëmm, who can see through people but not possess them
nooy	V	be soft
nop	B	love
nopp	N	ear
noppal	V	make things easy for, leave alone
noppaliku	V	rest; give up
noppalu	V	rest; give up
noppëliku	V	rest; give up
noppëlikuji	V	go and rest; die
noppëlu	V	rest; give up
noppi	V	be quiet; be ready
nos	V	talk through one’s nose
Nowàmbër	N	November
noyyi	V	breathe
nóóx	V	be dented
nóóx	V	be bent
nu	Q	how
nu	CLT	OBJ
nu	PRO	1PL.MIN
nu	PRO	3PL.MIN
nugg	V	be warm
nun	PRO	1PL.SUBJ
nun	PRO	1PL.OBJ
nuróó	V	look alike, match
nuróól	V	be like
nuróówaale	N	double
nuru	V	be like
nuyóó	V	greet
nuyóó	N	greeting
nuyóónté	V	greet each other
nuyu	V	greet
nuyu	N	greeting
nuyuji	V	go and greet
nuyusi	V	come and greet
ndaa	N	water pot
ndaama	N	short person
ndaje	N	reunion; association
Ndakaaru	N	Dakar
ndap	N	dish
Ndar	N	St. Louis
ndaw	V	be small
ndaw	N	adolescence
ndaw	N	woman
ndawal	N	meat, fish, and vegetables
ndawam	N	teenager
ndawràbbin	N	name of a traditional dance
ndawtal	N	money given to friends or relatives at the time of a celebration
ndax	CNJ	whether
ndax	CNJ	so that
ndaxte	CNJ	because
ndànk	V	be slow
ndànk	ADV	softly, slowly
ndànk-ndànk	ADV	very softly, very slowly
ndeke	INTER	I didn’t realize that
ndekete	INTER	I didn’t realize that
ndes	N	mat
ndesit	N	leftover
ndékkéé	V	have for breakfast
ndékki	V	eat breakfast
ndékki	N	breakfast
ndéy	N	mother
Ndéy	N	first name used before the name of an older woman for whom a girl is named
Ndéy	N	title used respectfully before the last name of an older woman
ndéyale	V	designate to serve as a substitute mother for
ndéyjóór	N	right side; right-hand person; good friend
ndéyóó	V	act as a substitute mother for 
ndënd	N	type of drum
Ndëpp	N	Lebou exorcism ceremony
ndës	N	mat
ndigal	N	instruction; religious obligation
ndigg	N	hip; waist
ndimbël	N	help
ndoket	N	type of dress
ndongo	N	student
ndono	N	inheritance
ndox	N	water; juice
ndugg	N	provisions
nga	PRO	2SG.NEUT.PFV; 2SG.NSUBJ.FOC; 2SG.MIN
ngaal	N	type of beetle
ngeen	PRO	2PL.NEUT.PFV; 2PL.NSUBJ.FOC; 2SG.MIN
ngalam	N	Senegalese gold
ngelaw	N	wind
ngelaw	V	be windy
ngemb	N	diaper
ngembu	V	have a diaper on
ngente	N	baptism
ngente	V	have a baptismal celebration
ngenteel	V	organize the baptism
ngë	PRO	2SG.NEUT.PFV; 2SG.NSUBJ.FOC; 2SG.MIN
ngir	CNJ	in order to
ngir	CNJ	so that
ngir	PRPO	for the sake of
ngoon	N	afternoon
ngooñ	N	dry leaves and hay used for cattle food
ngor	N	virtue, honor
ngot	N	type of fish
nguri	N	wasp
nguukë	N	hairstyle with two coiled braids over the ears
nguur	N	the upper class
nguuru	V	enjoy things
Njaago	N	Njaago person; Njaago language
njaal	N	condolences, sympathy
njaaloo	V	commit adultery
njaam	N	slavery
Njaaréém	N	Diourbel
njaatigé	N	colleague
njaaxum	N	inappropriate behavior, trouble
njaay	N	wares
Njaay	N	Senegalese dynasty
njaboot	N	family
njam	N	tattoo on the lower lip
njamala	N	giraffe
njambaan	N	type of snack food
njambataan	N	whooping cough
njañ	N	unbraided hair
njañu	V	have one’s hair unbraided
njar	N	drink made from soow, diluted with water and flavored with sugar and vanilla and mixed well
njar	V	make njar
njar	V	make njar; dilute
njariñ	N	helpfulness
njaxas	N	patchwork
njaxlaf	V	be energetic
njàmbataan	N	whooping cough
njàng	N	study
njegenaay	N	pillow
njëk	N	price
njëkk	V	come first
njëkk	V	arrive before
njëkk	V	V first
njëkké	N	sister of a woman’s husband, who traditionally is responsible for arranging the póót gift
njël	N	dawn
njënd	N	shopping
njiit	N	leader
njirim	N	orphan
njoganal	N	snack eaten after work or school
njoganaloo	V	have for a snack after work or school
njoganalu	V	eat a snack when one gets home from work or school
njolloor	N	lunch time
njombor	N	rabbit
njool	V	be tall
njoolaay	N	height
njoolanjool	V	be very tall
njóng	N	circumcision
njulli	N	newly circumcised boy
njuréél	N	birth, birth heritage
ña	DET	that
ñë	PRO	the ones that
ñaan	V	pray
ñaan	N	prayer
ñaanal	V	pray for
ñaar	NUM	two
ñaareel	N	second one; second wife
ñaareelu	NUM	second
ñaata	Q	how many, how much
ñaatë	Q	how many, how much
ñaaw	V	be ugly
ñaawaay	N	ugliness
ñaay	N	open field
ñadd	V	scrape from a dish with one’s finger
ñaddërem	N	10 fr. CFA
ñakk	V	vaccinate
ñale	DET	those
ñëlé	PRO	those
ñam	N	food
ñam	V	taste
ñambaan	N	type of snack food
ñan	PRO	who.PL, whom.PL
ñandaxit	N	snot
ñandu	V	blow one’s nose
ñaq	V	sweat
ñaq	N	sweat
ñasaxtiku	V	sniff
ñaw	V	be sharp
ñaw	V	sew
ñaw	N	sewing
Ñaw!	INTERJ	Serves you right!, Serves him right!
ñawkat	N	tailor
ñax	N	grass, straw
ñay	N	elephant
ñàkk	V	be scarce
ñàkk	V	waste; lack
ñàmbi	N	cassava, manioc
ñebbe	N	bean
ñee	V	be jealous of
ñee	DET	those
ñëlé	PRO	those
Ñeeño	N	member of any Senegalese caste other than Géér
ñeex	N	type of very thin sauce
ñeme	V	be daring
ñeme	V	not to be afraid
ñeme	V	not to be afraid to
ñeneen	PRO	some others
ñenent	NUM	four
ñenn	QUANT	some
ñent	NUM	four CFA
ñenteel	N	fourth one; fourth wife
ñenteelu	NUM	fourth
ñett	NUM	three
ñetteel	N	third one; third wife
ñetteelu	NUM	third
ñey	N	elephant
ñë	DET	the; that
ñë	PRO	the ones that
ñëlé	DET	those
ñëlé	PRO	those
ñëpp	QUANT	all
ñëpp	PRO	everyone
ñëw	V	come
ñi	DET	the; that
ñi	PRO	the ones that
ñibbi	V	go home
ñibbisi	V	come home
ñii	DET	these
ñii	PRO	these
ñiimëntu	V	eat slowly
ñilé	DET	these
ñilé	PRO	these
ñoddi	V	remove by force
ñoo	PRO	1PL.SUBJ.FOC
ñoo	PRO	3PL.SUBJ.FOC
ñoo	Q	who, whom
ñoom	PRO	3PL.SUBJ
ñoom	PRO	3PL.OBJ
ñooñu	DET	those
ñooñu	PRO	those
ñoor	V	thread a drawstring in
ñoor	N	drawstring
ñor	V	be cooked; be mature
ñori 	V	pull a cover off
ñorle	V	have one’s food be cooked
ñow	V	come
ñóóx	V	stuff in
ñóóxit	N	inside of bread or baked goods
ñóóxu	V	be stuffed in
ñóqqi	V	pull out
ñu	PRO	1PL
ñu	PRO	1PL.MIN
ñu	PRO	3PL.MIN
ñu	Q	who
ñulug	V	add water to
ñun	PRO	1PL.SUBJ
ñun	PRO	1PL.OBJ; 1PL.EMP.OBJ
ñungë	PRO	1PL.REM.IPFV
ñungë	V	be.1PL.FUT
ñungë	PRO	3PL.REM.IPFV
ñungë	V	be.3PL
ñungi	PRO	1PL.NEUT.PROX.IPFV
ñungi	PRO	1PL.NEUT.PROX.IPFV
ñungi	V	be.3PL
ñuul	V	be black
ñuul	N	black; type of tropical fruit with a black skin
ñuulël	V	make black
ñuulle	V	have one’s be black
ṉaam	N	jaw
ṉafeet	ADJ	wide open
ṉank	V	hold in one’s teeth
ṉarale	V	sit with one’s legs spread
ṉas	V	have the measles
ṉas	N	measles
ṉàppati	V	have smallpox
ṉàppati	N	smallpox
ṉàppeeku	V	spread one’s legs indecently
ṉàppi	V	spread
ṉàyyi	V	spread
ṉëp	V	have a handful of
ṉëpp	N	handful
ṉëppël	V	grab a handful for
ṉiin	V	grimace
ṉoos-ṉoos	N	long-handled hoe with a narrow blade
ṉóóbi	V	make a mocking face
ṉótt	V	be stingy
okk	V	scratch
okkatu	V	scratch oneself
Oktoobër	N	October
oliwud	N	chewing gumsingom oliwud
Olof	N	Wolof person; Wolof language
om	V	be skinny as a result of having lost a lot of weight
ommat	V	lead
oṉs	N	fishhook
opp	V	be sick
opp	N	sickness
oppeere	V	operate on
oppeere	V	have an operation
oppitaal	N	hospital
oraṉch	N	orange
oraṉch	V	be orange in colour
oraṉs	N	orange
oraṉs	V	be orange in color
ordal	N	order
ordonaas	N	prescription
otel	N	hotel
oto	N	car
oyof	V	be thin; be light; be friendly
oo	V	call
oolu	V	try get in touch with
oor	N	gold
oor	V	fast
oote	V	vote
óbbëli	V	yawn
óóm	N	knee
paa	N	father
Paa	N	form of address
paaka	N	knife
paan	N	washtub
paan	V	be broken; have a car breakdown
paañ	N	type of dried shellfish
Paap	N	form of address
paas	N	fare
paase	V	pass
paase	V	pass by; iron
pac	N	cure
pajaas	N	mattress
paket	N	package
palaalin	V	play hopscotch
palaas	N	place; position
palaat	N	plate
palanteer	N	window
palto	N	jacket
pantaloṉ	N	pants
pañe	N	basket
paranteer	N	window
parasol	N	umbrella
pare	V	be ready
Pari	N	Paris
pastel	N	small fried pastry stuffed with fish
pat	N	swollen gums
pat	N	dumpling
pataa	N	fat person
pataa	V	be fat
pataapuf	V	be fat
pataas	N	sweet potato
patroṉ	N	boss; successful person
patt	V	be blind in one eye
pattu	QUANT	one of a pair
pàkk	N	area with clearly defined boundaries
pànk	V	be belligerent
pàppa	N	father
pàppë	N	father
pàppë	N	term of address for a man
Pàppë	N	first name used before the name of an older man for whom a boy is named
Pàppë	N	title used respectfully before the last name of an older man
pàq	N	bald spot
pecc	N	dance
peccargo	N	wife of one's husbands' brother
peese	V	weigh
pengu	N	pin
peñe	V	comb
peñewu	V	comb
peṉsiyoṉ	N	pension
pepp	N	grain
per	N	bead
per	N	sheet metal fence
per	N	pearl
peresidaṉ	N	president
peresyoṉ	N	snap
perik	N	wig
perkaal	N	shroud
perl	N	pearl
persi	N	parsley
pes	V	slap on the face 
petaar	N	fireworks
petax	N	pigeon
petorool	N	lighter fluid
petrool	N	lighter fluid
pettaaw	N	cowrie shell; arrangement of cowrie shells for fortune telling
pettaaw	V	tell fortunes with cowrie shells 
pexe	N	business
péél	N	shovel
pénc	N	open place in a village where people meet and public events are held
pénku	N	east
Pël	N	Peulh person; Peulh dialect of the Fulani language 
pënd	N	dust
pënde	V	be dusty
picc	N	bird
picc	N	pimple
piil	N	battery
piis	V	wink
piis	N	piece
pikk	N	hoe; spades
piliweer	N	sweater
ping	N	pin
pingu	N	pin
pisin	N	pool
pitax	N	pigeon
po	N	game; play
polëtik	N	politics
polis	N	police
polisyé	N	policeman
politik	N	politics
polle	N	clove
pom	N	apple
pom	N	bridge
pombiteer	N	potato
pompyé	N	fireman
poobar	N	pepper
pooc	N	thigh
pooch	N	pocket
pooro 	N	leek
poos	N	pocket
poqataan	N	armpit
post	N	post office
poste	V	mail
pot	N	tin cup, tin can
poxataan	N	armpit
pónt	N	nail, screw
póón	N	tobacco
póót	N	washing; presentation of money and gifts to a new mother
pótit	N	used wash water
pullóóx	N	cassava, manioc
puluf	V	say a counting-out rhyme
puluf	V	participate in counting out
punéés	N	tack
pur	PRPO	for
pur	CNJ	in order to
pur	CNJ	so that
Purtugees	N	Portuguese Creole person from Guinea Bissau or Cap Vert; Portuguese Creole language
puseer	N	dust
pusó	N	needle
put	N	throat
puujpaaj	N	type of Senegalese rice dish
puup	N	bowel movement, feces
puus	V	push
puus-puus	N	wheel barrow
pwaar	N	pear
qànqal	N	fowl sp.
raaba	V	weave
raabakat	N	weaver
raaca	V	spread
raacu	V	be spread
raaf	V	be finished
raaga	V	be depreciate
raam	V	crawl
raañe	V	recognize
raapit	ADJ	fast
raaswaar	N	razor
raatale	V	mix up
raataloo	V	be mixed up
raax	V	plaster with cement or mud
raay	V	caress, rub, skid
raay	N	railroad track
ray-mbelle	V	play a tickling game with
ray-mbelle	V	play a clapping game
raazwaar	N	razor
rab	N	spirit; wild animal
rabe	V	be devilish
raf	V	twitch
rafet	V	be pretty; be fine
rafetaay	N	beauty
rafle	V	not to have anything else to wear
ragaju	V	roll one’s eyes
ragal	V	be afraid
ragal	V	be afraid of
ragga	V	scrub
raglu	V	be scary
raj	V	end
rajo	N	radio
rakk	N	younger sibling; younger cousin
rakka	N	younger silbing
randal	V	remove
randalkat	N	thief
randu	V	move
rangooñ	N	tear
raṉverse	V	corn row hair
raṉverse	N	corn rowed braid
rapaas	N	servant
ras	V	be wrinkled
ras	V	gather
rasta	N	dreadlocks
Rasta	N	Rastafarian
rasu	V	be gathered
rato	N	rake
raw	V	come first
raw	V	pull ahead of; twist
rawal	V	smuggle
rawale	N	smuggling
rawalekat	N	smuggler
rawante	V	race
rawante	N	race
raxas	V	wash
raxas	V	straighten one’s hair
raxas	N	type of old-fashioned hair straightening product
raxasu	V	wash one’s hands, wash oneself
ray	V	kill
ràbb	V	weave; knit
ràbb	N	woven item
ràbbkat	N	weaver
ràbbu	N	knitting needle
ràkk	N	complete act of praying 
ràkkaaju	V	be high-spirited; be unrealistic; go to extremes
ràndewuu	N	appointment
ràññ	N	brightness, visibility
ràññaaral	V	be bright; be visible
ràpp	V	be worn out
reécu	V	regret
reér	V	be lost
reéral	V	lose
reéw	N	country
rek	ADV	only
ren	N	this year
rew	N	stripes
rey	V	kill
ree	V	laugh
reega	V	be full
reegal	N	menstrual period
reelu	V	be funny
reen	N	root
reendi	V	slaughter
reer	V	eat dinner
reer	N	dinner
reeree	V	have smth. for dinner
rees	V	digest
rees	N	liver
reetaan	V	laugh, smile
reetaanlu	V	be funny
reew	V	be obnoxious; be rude
reewande	N	complaining
reewantu	V	complain
regeju	V	roll one’s eyes
rekk	ADV	only, just; completely
ren	ADV	this year
rendi	V	slaughter
repp	V	be asking for it; do what one is fated to do
res	N	liver
res	V	be responsible for
reseñ	N	grape; raisin
resiṉ	N	grape; raisin
respoṉsaabilité	N	responsibility
restoraṉ	N	restaurant
rew	N	stretch mark
rewle	V	help a woman deliver her baby
rewlekat	N	midwife
rey	V	kill
réccu	V	regret
réeba	V	be loose
résëñ	N	grape, current
réy	V	be large
réér	V	get lost
réérël	V	lose
réérlé	V	lose
rééw	N	country
rëbb	V	hunt
rëbb	V	point of the consequences of bad ways;
rëbba	V	hunt
rëcc	V	escape
rëcca	V	escape
rëdd	V	scribble
rëdda	N	strip
rëdda	V	write
rëgël	V	cook
rëkk	V	hit on the back
rëkka	V	hit
rëndee	V	cook
rënd	N	cooked meat, fish, and vegetables
rënka	N	crooked legs
rënxa	V	ripen
rëp	V	be exciting; have a lot going on
rës	V	dwindle
rëxa	N	sprain
rëy	V	be big; be loud
rëyaay	N	bigness
rëyërëy	V	be very big
riich	V	be rich
riichaay	N	wealth
rido	N	curtain
riib	V	rub, smear, spread
riir	V	sound
riir	V	attack
riis	V	be rich
riisaay	N	wealth
riiteé	V	chase
riiti	N	type of stringed instrument
rigiñ	V	mash
risit	N	receipt
rittax	V	be slippery
rob	N	funeral procession
robb	N	dress
robba	V	hunt
robine	N	copper, faucet
roccantal	V	make a half hitch knot in
rocci	V	pull out
roj	N	insect
romba	V	pass
roṉ	V	be round
ron	N	rum-palm
ron	PRPO	under
rongoñ	N	tears
ronu	V	undermine
roñoṉ	N	kidney
roob	V	bury
rooba	N	dress
rooceeku	V	be bruised
rooceeku	V	sneak
rooci	V	extract
roof	V	stuff, insert
roof	N	stuffing
roos	V	be pink
roose	V	water
root	V	get water
rooz	V	be pink
roppati	V	take
roppi	V	take
roq	N	narrow space
roqaat	N	cranny
rot	V	drop, fall 
rotiṉ	N	type of palm fiber used for baskets
roy	V	imitate
róbine	N	stand-pipe
rómb	V	pass
rón lal	N	area under the bed
róndal	N	area under the bed
ruñi	N	type of palm fiber used for baskets
ruccamti	V	make feel comfortable again; politely correct
ruccamtiku	V	make amends to
rucci	V	extract
rung	V	walk a long distance
rus	V	be ashamed
rus	V	be ashamed of
Rusi	N	Russia
ruslóó	V	embarrass
ruubaate	V	be jumble
ruuc	IDEO	very
ruuj	V	turn, clear
ruuñ	N	type of stew served at ceremonies
ruus	V	fall out, fall off
ruusaaleevër	N	lipstick
ruusit	N	flake
ruux	V	poke in the rear end, goose; churn
ruux	N	soul
rux-ruxi	V	jumble
ruuxu	N	dasher
ruy	N	pap
rwaa	N	king
sa	PRO	2SG.POSS
sa	DET	the; that
saa	PRO	1SG.POSS
saa	N	idiot, steer
saa	V	die
saaa	N	store
saaba	N	companion of the Prophet
saabu	N	soap
saaca	V	steal
saacee	N	thief
saacoo	V	commit adultery
saaf	V	fry
saafara	N	holy water
saaga	V	curse; insult, curse
saaga	N	insult, curse
saak	N	purse
saaket	N	fence
saaku	N	burlap sack
saal	N	living room
saalaaw	ADV	certainly
Saalum	N	Saloum; Saloum River
saam	V	put into piles, bunch, heap
saama	V	protect
saama	ADV	tomorrow
saamakat	N	shepherd
saami	V	tend sheep
saan	N	worm
saanga	V	cover
saangu	V	cover oneself
saani	V	throw
saañ	V	plug; force
saapi	V	be tasteless, have enough of
saapilet	N	rosary beeds
saar	N	chapter of the Koran
saari	V	be trend
saas	V	be smart
saas	V	be very hot, be fast
saas	N	moment
saasaay	V	be naughty
saaw	N	hedgehog
saa-waay	IDEO	hey you!
saay	N	time
saay	N	deth
saay-saay	N	playboy, joker
saayu-nekka	ADV	everytime
sabaadoor	N	type of long robe worn by men
sabar	N	drum
sabar	V	drum
sadd	V	be numb
saf	V	be tasty; be spicy; be painful
saf	V	taste like
saf	V	affect strongly
saf	V	care about
safal	V	season
safal	N	essence
safara	N	fire
Safara	N	Hell
safaay	N	flavor
sag	N	personality
saga	N	insult
sagal	V	honor
sagar	N	rag
saggan	V	be negligent
sago	N	calm
sago	N	desire
sakkan	V	be abundant
salaamaalekum	INTERJ	 hello
salaat	N	salad
salalaahu	N	the Prophet Mohammet
salbe	N	older boy who serves as a mentor for boys going through the circumcision
sale	PRO	that
sali	N	dried salted fish
salte	N	dirt
salte	V	be dirty; use dirty language
sama	PRO	1SG.POSS
samallu	V	be extraordinarily dressed
Samdi	N	Saturday
samp	V	plant
sampa	V	erect
sanaan	N	pineapple
sanaana	N	pineapple fruit
sanaana	N	pineapple plant
sanc	V	found
sanc	V	settle in
sang 	V	wash
sanga	V	bathe
sangoo	V	bathe with
sangoondoo	V	bathe together
sangu	V	take a shower
sanguji	V	go and take a bath
sangukaay	N	shower stall
sanguwaay	N	bathroom
sanku	V	be disappear
sanqal	N	oatmeal
sant	V	thank
sant	V	assign
sant	V	ask to perform a task
sant	N	thanks
sant	N	last name
santa	V	praise
santa	N	surname
sanxa	ADV	while ago
sanxal	N	rice, miller, maize flour
sañ	V	be daring; do anything one wants
sañ	V	V daringly, have the nerve to
sañca	V	start
sañse	V	be well dressed
sañu	PRP	1PL.POSS
saṉs	V	be smoking hot
saṉs	N	good luck
Saṉwiyé	N	January
sap	V	crow
sàpp	V	be well dressed
saqat	V	cough
sar	N	arse
sar	V	beat
sarax	V	forgive
sarax	V	give to
sarax	N	alms
saraxe	V	give a charitable donation
saraxeel	V	give a charitable donation on behalf of
Saraxolle	N	Sarakholé person; Sarakholé language
saraxu	V	beg
saraxukat	N	beggar
sarbet	N	towel
saret	N	cart
sareet	N	cart
sarga	EXCL	welcome
sarul	EXCL	get away
sas	N	assignment, challenge
satala	N	kettle
satalë	N	kettle
saw	V	urinate
saw	N	urine
sawar	V	keep busy doing things for oneself and others
sax	V	grow
sax	N	worm
sax	ADV	even, same
sax	ADV	actually
saxaar	N	smoke; train, ship
saxaar	V	smoke; be really angry
saxaarmi	V	shew
saxal	V	plant;
saxal	V	help grow
say	V	be in a bad mood
say	N	bundle
saytu	V	govern
sàcc	V	cheat
sàcc	N	thief
sàggan	V	be forgetful
sàkk	V	create; take part of
sàkk	V	take some
sàkket	N	bamboo fence
sàkket	V	put up barriers against
sàlli	V	have lost all taste
sàmm	V	herd
sàmm	N	herder
sàmmkat	N	herder
Sàndaga	N	Sandaga, a market in Dakar
sàndarma	N	gendarme
Sàndarmëri	N	Gendarmerie Nationale du Sénégal
sàng	V	cover
sàngam	N	some place
sàngara	N	alcoholic beverage
sànni	V	throw; avoid a subject while talking to
sànq	ADV	earlier today
Sàntëraafrik	N	Central African Republic
sàntiyoṉ	N	sample
sàññi	V	unplug
sàpp	ADJ	well dressed and made up
sàppi	V	be tasteless
sàppi	V	be uninteresting to
sàppi	V	be tired of
sàqami	V	chew
seben	V	urinate
sebenu	V	urinate on oneself
sebet	V	wash rice
sadaatle	N	shared
sedaatte	V	share
sedd	V	be cold
sedd	N	cold
sedda	V	be cold
seddoo	V	share
seede	N	witness
seén	V	sight
seéntu	V	expect
seéxa	V	join
see	PRO	that
seede	V	witness
seede	N	witness
seef	N	leader
seega	V	sift
seegukaay	N	filter
seel	N	ladder
seela	N	crevice
seela	V	be pious
seele	V	be caught between one’s buttocks
seen	PRO	3PL.POSS
seen	PRO	2PL.POSS
seena	V	leak
seepi	V	pick up
seere	V	be tight; be constipated
seereer	N	serer, a tribe originated from Senegal
seet	V	look for
seet	V	search
seetal	V	tell fortune
seetal	V	look for for
seetali	V	go and advise about the future
seetalsi	V	come and advise about the future
seetaan	V	watch
seeti	V	visit
seetkat	N	person who can see the future
seetlu	V	notice changes; seek advice about the future; observe
seetluji 	V	go and seek advice about the future
seetsi	V	come and visit
seetu	V	look at oneself
seetu	N	mirror
Seex	N	Sheikh
seey	V	melt
seeyal	V	melt
segg	V	strain
segg	N	leopard
segga	V	bend down
segga	N	tiger
seku	N	parrot
selaw	V	quiet down
selbe	N	older boy who serves as a mentor for boys going through the circumcision period
selew	V	be quiet
selew	N	still
sell	V	be holy; be respected
sellal	V	try to act dignified
sempi	V	take out
Senegaal	N	Senegal
Senegaleezmaṉ!	N	Senegalese-style!
senn	V	leak
sentuur	N	belt
seppi	V	remove from hot oil or water
Septàmbër	N	September
Seraalewon	N	Sierra Leone
sereti	N	spit that comes between one’s teeth
seretiku	V	spit through one’s teeth
seriñ	N	muslim, marabout
sernde	N	witness
seruñtu	V	consult a marabout
servalaṉ	N	kite
set	V	be clean
set	N	seven
set	ADV	very
setal	V	make clean
set-setal	V	clean up
setul	V	be having a menstrual period; have just given birth
sew	V	be thin
sex	V	have something in one’s mouth
sexal	V	feed
sexaw	N	traditional Senegalese tea
seyaan	N	stream
Seytaane	N	Satan, trouble
seytaane	V	be a meddler
sébet	V	stop raining
sécca	V	be sticky
sédaale	V	divide
sédd	V	share with
séddëlé	V	divide
séemeñ	N	axe
séet	N	bride
séexa	N	cock
ségaa	N	over bend
séwët	V	stop raining
séén	V	see a long way off
Sééréér	N	Serer person; Serer language
sééx	V	have twins, triplets, etc.; give birth to twins, triplets, etc.
sééx	N	twin, triplet, member of any multiple birth
sééxlu	V	be disgusting; be fastidious
sééxlu	V	be disgusted by
sémmiñ	N	ax
séntiir	N	belt
séntuur	N	belt
séq	N	rooster
séwët	V	stop of rain
së	DET	the; that
së	PRO	2SG.POSS
sëb	N	bean
sëcc	V	have a persistent smell
sëf	V	load
sëf	V	load on
sëgg	V	bend over; be stooped
sëkk	V	fill in
sëlé	PRO	that
sëlëm	V	wash, wash face
sëlëx	V	throw or kick
sëlmu	V	wash one’s face
sëm	V	surround
sën	V	dumpster or other large container for garbage; dump
sëng	V	palm wine
sënga	N	palm wine
Sëp!	INTERJ	Shoo!
sëc	V	be hairy; be bushy
sëqët	V	cough
sër	N	sarong
sërica	EXCL	welcome
sëriis	N	cherry
sëriis	N	cherry tree
sëriñ	N	teacher; older man; husband; male fortune teller
sëriñtu	V	do the work of a sëriñ for money
sës	V	be exhausted
sës	V	push all the way
sësël	V	push all the way for
sët	N	grandchild; blood relative of one’s grandchild’s generation
sëtaat	N	great-grandchild; blood relative of one’s great-grandchild’s generation
Sëwis	N	Switzerland
sëxa	V	be hairy
sëxat	V	cough
sëy	V	get married 
sëy	N	marriage
Sëytaane	N	Satan
si	DET	the; that
si	PRPO	to, of, about
si	QUANT	some
si	PRT	FUT.IMP
si	PRPO	in, on, there about
sib	V	dislike
sibbiru	N	fever, malaria
sibbiru	V	have a fever, have malaria
sibir	N	the second day after
sebiru	V	have fever, have malaria
sibooru	V	follow, follow someone for money of material
siddéém	N	jujube
siddéém	N	jujube tree
siddi	V	skin
siddit	N	blood vessel; vein, artery
sifle	V	whistle
sifone	V	be wrinkled
sigaret	N	cigarette
siggi	V	straighten up
sii	PRO	this
siif	V	take away
siim	V	mix
Siin-Saalum	N	region between the Sine and Saloum Rivers
Siin-siin	N	person from the Sine region
siiñ	V	smile showing one’s teeth and gums
siiraas	N	shoeshine
siiraaskat	N	shoeshine person
siiru	N	wild cat
siis	V	be inhospitable,be jealous
siis	N	chair
siisënté	V	be inhospitable to each other, not to be generous with each other
siit	V	drip
siiwal	V	tell on
sikim	N	chin, beard
siw	V	be very famous
Sikaap	N	government-sponsored real estate development in Dakar
sikk	V	be likely to be in trouble 
sikket	N	billy goat
sikkim	N	chin; beard
silé	PRO	this
silip	N	underpants
siletmaa	N	undershirt
silmaxa	N	blind person
simba	N	masquerade, a wolof masquerade dressed and acting like a lion
siimeéku	V	be undressed
simi	V	dethrone, undress
simis	N	shirt
simmeeku	V	get undressed
simmi 	V	take off
sindax	N	lizard
sinemaa	N	cinema
singom	N	chewing gum
Sinwaa	N	Asian person; Chinese language
sip	V	hate
sipi	V	pick up
sipp	N	skirt; half slip
sippa	N	skirt
sippa-sippa	N	strimp
sippax	N	strimp
sippëli	V	let out at
sippi	V	let out at
sippoṉ	N	slip
siraas	V	shoe shine, polish
siso	N	scissors
sisó	N	scissors
sitengors	N	bra
siteṉ	N	bra
sitoronaad	N	lemonade
sitronaad	N	lemonade
siwó	N	bucket
so	V	offer
sob	V	be noisy
soble	N	onion; person who wears many layers of clothing
soc	V	have a cold
soc	N	cold
socc	N	clean
soccu	N	chewing stick
sof	V	load
sofëër	N	driver
sofóór	N	driver
soga	V	have just done
soj	V	have a cold
sokk	V	give a splinter
sokku	V	have a splinter
sokolaa	N	chocolate
sokolaa	V	be brown
sol	V	dress
sold	N	salary
soldaar	N	soldier
solde	V	sell at a discount
solin	N	appearance
solo	N	importance
soloh	N	business
solu	V	be dressed
sombi	V	type of rice dish containing buttermilk and flavorings
sombi	V	make sombi
sombi	N	rice dish
sondeel	N	candle
sone	V	ring a bell
sone	V	hit
song	V	attack
songoo	V	attack each other
sonn	V	be tired
sonnal	V	make tired
sop	V	be disruptive
sopp	V	like
soppeeku	V	change
soppi	V	change
soppi	N	change
soqqi	V	pluck
soraans	N	orange
soraṉs	N	orange
sore	V	be far away
sori	V	be far away
sos	V	make up
sotteeku	V	run of water
sottëli	V	finish
sotti	V	be over
sotti	V	pour
sottil	V	pour for
soxla	V	need
soxla	N	problem
soxlë	V	need
soxlo	V	need
soxlo	V	be necessary that
soxna	N	woman
soxna	N	term of address for a woman
soxor	V	be mean; be unmanageable
soo	CNJ	if; when
soo	N	offering, puncture
soo	V	pierce, go through
soobee	N	diligence
soobee	V	be please
soobu	V	get oneself wet
sooca	V	scrub
soocet	N	cricket
soocu	N	chewing stick
soof	V	be bad tasting
soof	V	have a bad attitude; be boring; be stuck up
sooga	V	have just started
sooga	V	have just done
soon	V	be yellow
soona	V	be tired
soonal	V	be suffering
Sooninke	N	Soninke person; Soninke language
soop	V	get harder
soop	V	plate with a precious metal
soope	N	admirer
soos	N	sauce
Soose	N	Socé person; Socé language
soosu	PRO	those
sooti	V	insert, tuck
sooti	V	be accomplished
soow	N	sour milk
soow	V	yell at
soow	V	talk loudly
soox	V	limp
sooxa	N	pound
sooy	IDEO	contempt
sooy	N	silk
sóf	V	load
sóq	V	pound in a mortar
sóqkat	N	person who pounds grain
sókkorotu	V	pick one’s teeth
sóobu	V	plunge
sóór	V	put rice into boiling water
sóór	V	putin boiling water
sóóx	V	limp
su	PRO	REL.SG
su	PRO	any_that
su	CNJ	if; when	
su	N	cabbage
suba	N	morning
subba	N	tomorrow, morning
subë	N	morning; tomorrow
subux	V	poke
suceṉ	N	bra
Sudaṉ	N	Sudan
sufuné	V	be rumpled
sujeer	N	pot
sukk	V	kneel; bend one’s knees slightly and bob while standing as a gesture of respect
sukka	V	kneel
sukkar	N	sugar
sukkur	N	sugar
sukkuraat	V	approach death
sukkuraat	N	death
sulla	N	penis
sulli	V	dig up; bring up
sulli	V	bring up a difficult subject
Sulyé	N	July
sulyé	N	shoe
suma	CNJ	if; when
suma	PRO	1SG.POSS
sumb	V	start washing
sumb	N	wash cycle
sumb xulóó	V	start a fight
sumblé	V	help start the wash
sumblé	V	help start
sumi	V	undress
summeeku	V	get undressed
summi	V	undress
sump	N	type of tropical fruit
sunguf	N	powder
sunna	N	devout behavior
sunu	PRO	1.PL.POSS
sungeen	CNJ	if; when
sunguf	N	millet flour
suñu	PRO	1.PL.POSS
suñu	CNJ	if; when
supa	N	okra soup
suppome	N	cabbage
supp	N	soup
suraat	N	verse of the Koran
surga	N	dependent, roving farmers
surgë	N	dependent hanger-on
suruxal	N	slot
Susu	N	Sussu person; Sussu language
sutal	V	be completed
suti	N	tool
suti	V	be completed
sutura	N	confidence; decency
sutura	V	be covered
sutura	V	save person's secret, bury a corpse
suturaal	V	be tactful with
suturë	N	confidence; decency
suub	V	dye
suuf	N	sand, dirt; bottom
suuféél	V	put down, make feel low
suukër	N	sugar
sukkër	V	put sugar on
sukkër	V	sugar, put sugar on
suul	V	plant; end
suul	N	burial
suulé	V	bury with
suum	N	lobster
suur	V	be full
suusal	N	steam
suux	V	sink
suuyee	N	July
suwaa	N	silk
suweer	V	put under glass
Suweṉ	N	June
suwetmaa	N	underwear
suwo	N	Juné, home
suxi	V	pluck
suy	V	sprinkle
swaa	N	silk
sweijeex	V	be skinny
ta	CNJ	and
tabala	N	drum
tabax	V	build
tabax	N	solidly constructed building
tabaxkat	N	builder
tabaxlu	V	get something built for oneself
taf	V	rub up against in a sexual way; patch, cover; refuse to talk to
taf	V	stick
tafaar	N	crime
taga	V	praise
tagal	V	fix headscarf so that it is pulled forward off the back of her head, so that her braids show
tagalu	V	have one’s headscarf pulled forward off the back of one’s head
tagg	V	praise
tajoor	N	tailor
tak	V	stick, be stuck; come to rest after flight
takandeer	N	shadow
takk	V	tie; marry
takk	V	get married
takk	N	wedding
takka	V	tie, marry
takkarnaase	ADV	continuous
takki	V	go and marry
takksi	V	come and marry
takkusaan	N	4:30-5:00pm
taksi	N	taxi
Talaata	N	Tuesday
talaata	V	slap on the face
talaata	V	divide
tali	N	street
tam	ADV	too, also 
tam	V	accuse, accuse someone of witch craft
tama	N	small drum
tamaate	N	tomato
tame	N	sieve
tame	V	sift
tame	N	large sifter or strainer
tami	V	sift
tamit	ADV	too, also
tamomoita	N	thermometer
tamostaat	N	thermostat
tampe	N	stamp
tan	N	eagle
tan	V	be better
tane	V	be better
tanc	V	crush
tandale	V	guess
tanduus	V	guess
tane	V	be better
tane	V	be better than
tani	V	tell fortunes with cowrie shells
tani	N	arrangement of cowrie shells thrown for fortune telling
tanil	V	tell fortune with cowrie shells
tanilsi	V	come and tell fortune with cowrie shells
tangaay	N	warm weather
tangool	N	heat
taṉ	N	season
tanka	V	memorize, save from trouble
tanka	N	protect
taṉṉ	V	have diarrhea
taṉsiyoṉ	N	high blood pressure
tanta	N	aunt
tanxa	V	water, draw
tanq	V	dip
tanq	V	dip water
tanqal	V	disturb
tangal	N	candy
tañca	V	insult
taṉ	N	season
taṉ	V	steam, plaster
tapa	V	stick, pin
tapale	V	rip off
tapaas	V	trouble
tapaat	N	fence
tape	N	carpet
tapp	V	pin
tappale	V	pretend; V make up an excuse
taq	V	share a wall
taq	V	cling to
taq	V	be covered with
taqandeer	N	shadow
tar	N	pile
taraase	V	slice
tarde	V	be late; be out of style
tari	V	recite
tas	V	spread out; take apart; comb out; break up
tas	V	break up, be broken up; get out; be tired
tasaare	V	spread out
tasaaroo	V	be scattered all over
tasat	V	spread out
tase	V	meet
tasee	V	meet
taseel	V	meet
tasiyoṉ	N	hypertension
tasyoṉ	V	watch out
taw	V	rain
taw	V	have rain
taw	V	rain
tawat	V	be sick
tawat	V	complain
tawte	V	be rained on
tax	V	cause
taxa	V	stain
taxan	V	get wood
taxani	V	go and get wood
taxañ	V	wrap up loosely; braid loosely or casually
taxañ	V	fetch firewood
taxañu	V	braid one’s hair loosely or casually
taxaw	V	stand; stop
taxawaalu	V	hang around
taxawaay	V	be tall
taxawu	V	help out; annoy; hang over
taxe	V	be sticky
tay	ADV	today
tay	V	do it on purpose
tay	V	steam
tay	N	stick
tayal	V	be lazy
taybaas	N	type of low-waisted blouse
tayëër	N	tailor
tayle	V	pawn
tay-taylu	V	pretend
taa	V	be standing
taa	V	accept, depart
taa	N	puddle
taab	N	boil, abscess
taabël	N	table
taabi	V	fill
taabul	N	table
taaca	V	be flat
taacu	V	clap
taaga	N	nest
taagaatle	N	sperate
taage	N	obituary announcement
taagee	N	death announcement
taagu	V	take leave, take a permission
taaj	V	put down to start a meal; confront, put
taaka	V	alight
taal	V	start food cooking
taal	V	turn on
taal	V	start, kindle
taal	N	cooking fire
taalal	V	go straight
taalaale	V	put food into hot oil to begin the cooking process
taali	V	be straight
taalibe	N	student
taalube	N	arabic scholar
taama	V	walk
taama	V	be addicted to
taambali	V	begin
taamu	V	select
taamu	V	pick and choose
taanal	V	select
taandarma	N	date tree, date fruit, dates
taanga	V	be hot
taap	V	be infected
taap	N	infected sore
taapa	V	castrate
taapandaar	N	flat, flat fish
taaparka	N	flat wood
taar	N	beauty
taaru	V	be beautiful
taas	N	cup
taat	N	buttocks
taataan	V	collect rain water
taaw	N	oldest child
taawloo	V	have as one’s oldest child
taax	N	solidly constructed building
taax	N	city
taaxale	V	separate
taay	V	be chubby
taay	N	size
taayi	V	separate
taaye	V	prune
taayekaay	N	pruning shears
Tabaski	N	Day of Sacrifice
tàcc	V	be flat
tàccal	V	compress
tàcc-tàccal	V	flatten
tàccu	V	clap
tàccu	V	applaud
tàggatoo	V	say one’s goodbyes
tàggatoo	N	farewell
tàggoo	N	say goodbye; ask for permission
tàggu	V	say goodbye to; ask for permission
tàkk	V	catch fire, go on
tàkkusaan	N	late afternoon, late afternoon prayers
tàll	V	be white
tàllal	V	go straight
tàllal	V	stretch out; straighten, relax
tàmbali	V	start
tàmbëli	V	start
tàmm	V	be used
tàndarma	N	date
tàndarma	N	date palm
tàng	V	be hot; be bad-tempered
tàngaay	N	heat
tàngal	V	heat
tàngal	N	candy
tàngat	V	be bad-tempered
tànk	N	foot, footstep, footprint, leg
tànn	V	choose
tànn	V	select; pick over
Tànt	N	aunt
tàntë	N	aunt
Tàntë	N	title used respectfully before the last name of an older woman
tàppaat	N	sheet metal fence
tàppet	V	be scared
tappet	V	male homosexual
tàppi	N	carpet
tàqarñi	V	undo
tàwwi	V	stretch
tàwweeku	V	be stretched
tàyyi	V	be tired
te	CNJ	and, also, then
teb	V	be full
tedd	V	be blessed; be respected
teddi	V	leave
tefes	N	beach
teg	V	start cooking; bet; have passed
teg	V	put down; place
teg	V	have in addition
teggi	V	remove
tegle	V	stack
tegu	N	scarf
tek	ADV	very, exactly
tek	N	stake
tekle	V	have on many layers of clothing
tek	V	start cooking; bet; have passed
tek	V	put
tek	V	have in addition
tekk	V	be quiet and calm
tekki	V	take off; translate, explain
tekkil	V	translate for, explain to
tekle	V	stack
tekle	V	have on many layers of clothing
tele	N	television
telefon	N	telephone
telefone	V	telephone
televisyoṉ	N	television
tembar	N	postage stamp
temp	V	walk slowly
teṉ	N	complexion
tene	N	tiger, panther
teneṉ	N	winnowing basket
teppi	V	take out
teqale	V	judge; separate
teral	V	honor
teral	V	entertain
teranga	N	respect, hospitality
terànga	N	hospitality
teràngë	N	hospitality
tere	V	forbid
terende	N	article lying about
teretuwaar	N	footpath
tereene	N	article lying about
tette	V	help out; help walk
tette	N	tutorial
tey	V	do deliberately
tey	N	today
teyaatar	N	theater
teeda	V	be comfortable
teegi	V	remove
teeki	V	succeed
teel	V	be early
teel	V	do early
teela	N	shallow frying pan
teen	ADV	well
teen	N	lice
teeṉ	V	be meek
teer	V	stop
teer	V	land
teeral	V	have done everything
teere	N	amulet, book
teertu	V	welcome
teeru	V	welcome at, meet at
teeru	N	landing area for fishing boats, port
tees	V	stop
teesal	V	reach one's limit
teew	V	be present
teewe	V	be there for
teewee	V	witness
teexet	V	be stubborn
teey	V	be patient
teey	ADV	more carefully
teeyi	N	still
téeméer	NUM	hundred
téen	N	well
téé	V	have tea
téé	N	tea
tééméér	N	hundred
tééméér	N	500 fr. CFA
téémééréél	NUM	hundredth one
téémééréélu	NUM	hundredth
téén	V	look up
tééñ	N	head louse; rolled cloth used to support something carried on the head
tééñ	V	have lice
tééñu	V	use a rolled cloth to support something on one’s head
tééré	N	book; type of amulet, a leather pouch containing sacred verses
tééy	V	become clear, have the sediment settle; be deliberate
tééylu	V	calm down
ténj	V	go through the traditional period of mourning for one’s husband
ténj	N	traditional period of mourning by a widow for her husband
téyé	V	hold, restrain
téyékaay	N	potholder
të	V	be difficult to deal with
tëb	N	spring
tëb	N	leap
tëcc	V	pound
tëcca	V	hurt
tëccu	V	have one’s finger get pinched or caught; have a discolored fingernail as a result of an injury to one’s finger
tëdd	V	lie down; sleep
tëdd	V	sleep together
tëdda	V	go to bed
tëdda	V	lie down
tëddaay	N	lying down
tëddi	V	go to bed
tëfli	V	spit
tëfli	V	spit out
tëflit	N	spit
tëga	N	black smith, silver/gold smith
tëga	V	play drums
tëgakat	N	drummer
Tëgg	N	member of the Senegalese metalworkers caste
tëgg	N	artisan
tëgg	V	beat
tëggkat	N	drummer
tëj	V	close
tëj	V	close; sentence
tëju	V	be closed
tël	V	bounce back and keep it in the air; kick up with one’s foot
tëla	N	cutlet of fish
tëll	N	piece
Tëngeej	N	Rufisque
tënja	V	mourn
tëñlaay	N	turban
tëñlaayu	V	have on a turban
tëp	V	jump
tër	V	have filth on one’s body
tër	V	trap
tër	N	body filth
tëral	V	enact
tëreefal	N	clubs
tërëdi	V	toss and turn
tërël	V	lay down
tërin	N	lying position, the position in which one is lying
tëstan	N	foot
tëstën	N	heel
tëstës	V	be business like
tëx	V	be deaf
tëxa-tëxa	N	difficulty
tibb	V	take part	
tibb	N	handful
tibba	V	take a handfull
ticca	V	hurt
tichóóli	V	sneeze
tigadege	N	peanut butter
tijji	V	open, turn on
tikét	N	ticket
tilim	V	be dirty
tilim	N	dirt
till	N	jackal
timis	N	sunset prayers; sunset, dusk
Tinisi	N	Tunisia
tir	ADV	suddenly
tis	V	splash
tisbaar	N	midday prayers; early afternoon
tisoól	V	sneeze
tissóóli	V	sneeze
tisu	N	material, cloth
tiye	V	hold
Tiijaan	N	Muslim sect; member of the Tiijaan sect
tiim	V	perform one’s ablutions before prayer symbolically, without water, using sand or a prayer stone
tiim	V	look down at
tiimkat	N	mid wife
tiiñal	V	accuse
tiir	N	palm tree, palm seed
tiir	N	palm juice, palm oil
tiire	V	be aim
tiis	N	sorrow
tiit	V	be afraid
tiitànge	N	fear
tiitël	V	scare
tiitër	N	pride
tiitëróó	V	brag about
tiitëru	V	show off
tob	V	leap
toccami	N	skin lotion
toccamiku	V	put lotion or Vaseline on oneself
tofo	N	younger sibling
toftof	N	motor bike
togg	V	cook
togg	N	prepared dish
toggantu	V	play at cooking
toggëntu	V	play at cooking
toggkat	V	cook
toggsi	V	come and cook
toggukaay	N	cooking utensil
Togo	N	Togo
toj	V	split
toj	V	be broken
tojal	N	baby’s feces, baby’s bowel movement
tojat	V	break into little pieces
tojot	V	break into little pieces
tolloo	V	be the same size 
tolloo	V	reach
tollool	V	be the same size as
tollu	V	be tall
tomaate	N	tomato
tomaate-loxati	N	tomato paste
tontu	V	answer
toóy	V	be stupid
toocarmeku	V	apply oil on one's body
toog	V	sit, stay
tooga	V	cook
toogakat	V	cook
toogandi	V	sit and wait for a while
toogaanu	V	sit around and bother
toogu	N	chain
toogukaay	N	seat
tooj	N	bench
tool	N	garden
toolaale	V	compare
tooloo	V	be equal
toombee	N	coincidence
tooñ	V	be guilty
tooñ	V	do wrong to; judge guilty of being a dëmm
tooñ	V	trespass
tooñardi	V	fix
toopa	V	follow
toopandoor	V	imitate
toopatoo	V	take care of
toope	V	follow
tooris	N	tourist
toot	N	male homosexual
tooxa	V	drip
tooxa-tooxa	N	stain
tooy	V	be wet; ache all over; be sexy
tooyaay	N	dampness
tooyal	V	get wet
tooye	N	wetness
topp	V	follow,; go alongside
topp	V	slide over
toppal	V	follow for
toppandoo	V	imitate
toppatoo	V	look after
torop	ADV	too; very; and how!
torotuwaar	N	sidewalk
torox	V	be ashamed, suffer
toroxte	N	shame
toxal	V	move
toxo	INTERJ	interjection used to someone who is coughing
toxoñ	V	rub
toxo-toxo	INTERJ	interjection used to someone who is coughing
toxu	V	move
tóntóor	N	sprout
tóntu	V	answer
tóñ	V	help
tóṉṉ	V	ignore
tóq	V	drip
tóq	N	drop; little piece
tóttóór	V	flower
tóttóór	N	bud, flower
tóx	V	smoke
tóxkat	N	smoker
tóór-tóór	V	flower
tóór-tóór	N	bud, flower
tóóy	V	be awkward; be dull
treefël	N	clubs
tribunaal	N	court
tubaab	N	white person, Caucasian, foreigner
tubaabe	V	be neat; be European-style
TubaarfakÀlla!	INTERJ	Thanks be to God!
TubaarkÀlla!	INTERJ	Thanks be to God!
tubbi	V	leave Islam and convert to another religion
tubéy	N	pants
tubëy	N	pants
tudd	V	hold a naming ceremony 
tudd	V	be named
tudd	V	name; speak to after a period of coolness; ordain
tudda	N	name
tuddee	V	name
tuddéé	V	name
tuddéé	V	name after
tuddëndóó	N	namesake
tuddënté	V	speak
tufli	V	spit
tuflit	N	saliva
Tugël	N	France
tukki	V	travel
Tukulóór	N	Tukolor person; Tukolor dialect of the Fulani language
tund	N	mountain
tunda	N	hill
tuñ	N	lip
tuñ	V	mulch
tur	N	first name; whole name
turandoo	N	namesake
turki	N	shirt
tus	PRO	nothing
tusngël	N	kohl used for eye liner
tusungal	N	kohl
tusuñé	N	cook
tusuur	ADV	all the time
tusuur	V	always
tux	V	smoke
tuxkat	N	smoker
tuub	V	apologize
tuubal	V	forgive
Tuubaa	N	Touba
tuubéen	N	proselyte
tuuf	N	ointment
tuufa	N	snail, shell fish
tuuk	IDEO	quiet
tuumal	V	accuse
tuumaal	V	make up stories about
tuup	V	convert to Islam
tuur	N	spirit
tuur	V	spill
tuur	N	turn
tuuru	V	spill; be abundant
tuuti	V	be a little bit
tuuti	N	a little
tuutiwaay	N	smallness
tuux	V	be content
ub	V	cover
ubbeeku	V	open
ubbi	V	open
ubbil	V	open for
ubbité	N	opening
ubbu	V	be closed
ubéeku	V	be opened
ubu	V	be closed
um	V	bring bad luck
umpa	V	be a mystery
umpaañ	N	uncle’s wife
umra	V	make a pilgrimage to Mecca at Korite
umra	N	pilgrimage to Mecca at Korite
umraji	V	go and make a pilgrimage to Mecca at Korite
umu	V	have bad luck for the day
unka	N	wall gecko
up	V	close
upp	V	fan
uppóó	V	fan oneself with
uppu	V	fan oneself
uppukaay	N	fan
urlé	V	hem; shorten by turning up the edge
urlé	N	hem
urus	N	gold
Ut	N	August
ut	V	look for, find
ute	V	be different
utee	V	be different
utee	N	difference
uti	V	go and look for
utsi	V	come and look for
uyu	V	answer
uude	N	cobbler
uuf	V	carry
uuf	V	take care of
uul	N	fruit of the locust bean tree, whose seeds are used to make netetu
uude	N	leatherworker, shoemaker
uum	V	start Ramadan
uum	V	experience an uncomfortable sensation
uus	V	abandon
uutu	V	succeed
vale	N	jack
vaniiy	N	vanilla
veer	N	green
veer	N	glass
velo	N	bicycle
vert	N	green
vespaa	N	motor scooter
vest	N	sleeveless jacket
wa	DET	the, that
wacc	V	abandon
waccu	V	vomit
wacu	V	vomit
wadd	V	fall
waddal	V	drop
waks	N	type of printed cloth
wal	V	pound into flour
wal	V	throw
wala	CNJ	or, as well
walangaan	V	flow
walangaan	N	down pour of water
walanteeru	V	volunteer
walax	V	bail out water
walaxnja-xaan	N	larva
walaakaana	V	be poor
walbati	V	turn around, turn inside out
wale	PRO	that
wali	V	go and pound grain into flour
walis	V	 whistle
walla	CNJ or
walliiwu	N	saint
walliiyu	N	saint
wallu	V	assist
walukaay	N	industrial grinder one can use in the market
wan	V	show to
wana	V	swallow
wanag	N	toilet, back yard, bath
wanak	N	bathroom
wane 	V	show
wane	V	showon in
wanewu	V	show off
wani	N	vanilla
wann	V	swallow
wante	CNJ	but
wanxe	N	beetle
wañ	V	wring
wañaar	V	twist
wañaaru	V	be twisted
wañeeku	V	turn around and go back
waññi	V	count; send back
waṉ	N	buttocks
waṉ	V	have big buttocks
waṉ	N	buttocks
war	V	be the duty of
war	V	climb on
war	V	have to
war	V	ride
warax	V	swallow without chewing
waraaj	N	cemetery, grave
warga	N	Chinese tea
wargu-yaram	N	good health
warugal	N	obligation
warugar	N	dowry; duty
wasin	V	give birth
wasintoor	N	scales
wat	V	shave; cut hair
watat	V	drag
wateef	N	haircut
watiir	N	horse-drawn carriage
watkat	N	barber
watoo	V	shave oneself with
watteen	N	cotton
watu	V	get shaved; cut one’s hair, get a haircut
wax	V	tell
wax	V	speech; business
waxaale	V	bargain
waxaale	N	bargaining
waxaat	V	repeat
waxal	V	speak to
waxal	V	tell for
waxambaane	N	young man
waxe	V	talk with
waxee	V	talk with
waxin	N	way of talking
waxtaan	V	discuss
waxtaan	N	conversation
waxtaane	V	discuss
waxtu	V	talk to oneself
waxtu	V	soliloguy
waxtu	N	period
waxtu	N	time; hour
way	EXCL	showing surprise
way	V	set
wayaan	V	praise
wayaas	N	trip
wayaase	V	travel
wayo	N	pool, stream
waa	N	inhabitant
waa	V	keep doing
waabajiiba	N	troublemaker
waac	V	prepare for
waac	V	be in danger of, be about to
waaca	V	descend
waaf	N	dock
waaf	V	ambush
waafu	N	siege
waajur	N	parent
waaka	V	throw
waakirlu	V	volunteer
waal	V	veil
waala	V	part
Waalaa!	INTERJ	There! Voilà!
waale	V	be contagious
waali	V	join
waaliyaan	N	foreigner
Waalo	N	Oualo
Waalo-waalo	N	person from Oualo
waame	V	be moody
waame	N	tide
waan	N	van
waane	V	be a troublemaker; be hypocrite
waane	N	troublemaker
waanent	N	conjuntivites
waañ	N	kitchen
waañeeku	V	have lost weight
waañeeku	V	be reduced
waañi	V	reduce 
waar	V	preach to
waar	V	be amazed
waar	V	plot of ground
waar	V	be shocking
waar	N	acre
waaraate	V	preach
waare	V	preach
waaru	V	be amazed; be mystified
waas	V	insult, clean
waas	N	tilapia
waasintoor	N	scale
waat	V	swear
waatiir	V	tie
waaw	PRT	yes
waaw	ADV	by the way
waawaaw	ADV	certainly
waawkañ	ADV	of course
waaxu	V	walk fast
waay	INTERJ	please
waay	INTERJ	give me a break!
waay	N	man, boyfriend,
waay	CNJ	but
waaye	CNJ	but
wàcc	V	descend; get off work
wàcc	V	get off
wàcce 	V	help to descend; get down; lengthen
wàccewaale	V	bring down as well
wàll	N	share
wàll	V	give a disease or opportunity to
wàll	V	infect with; let rub off on
wàlle	V	be contagious
wànnent	V	have conjunctivitis
wànnent	N	conjunctivitis
wànte	CNJ	but
we	N	fingernail, toenail
wecc	IDEO	very
weccee	V	exchange
wecceeku	V	get change
wecci	V	change money for
weccit	N	change
weccoo	V	trade
wedaañaamu	V	peep
weddi	V	deny
wekki	V	pull
welo	N	bicycle
weñ	N	fly
weñ	N	metal; wire; car
weñ	N	iron
weṉ	V	throw
wer	V	be feeling better; be healthy
wer	N	good health
weradi	V	be sickly
werante	V	argue
werante	V	be argumentative 
werante	N	argument
werdd	V	pass a prayer bead through one’s fingers while saying the required prayer, to say prayers with prayer beads
werëdi	V	be sickly
wert	N	green
werta	N	green
weseṉ	V	be dry
weseṉ	V	be dry
wet	N	part; surroundings
weteñ	N	tick
wetu	ADV	next
wex	V	be bitter; be bad tempered
wextan	N	gall bladder
wexxa	V	kick
wey	V	go away
wey	N	fingernail, toenail
wee	PRO	that
weedi	V	deny
ween	N	breast
weer	N	moon; month
weer	V	hang up to dry; reveal secrets about 
weer	N	glass
wees	N	passing
wees	V	pass
weesu	V	pass
weex	V	be white
weex	N	white
weexa	V	steal
weexal	N	bleach
weexbët	V	be unsatisfied with the spouse or lover one has, be unwilling to make a commitment, be greedy for more sexual attention
weexu	V	kick
wéecée	V	exchange
wéet	V	be lonely
wér	V	be well
wéradi	V be sick
wéy	V	be crazy
wéér	V	lean against a surface
wééru	V	be leaning back
wéét	V	be lonely
weq	V	kick
wéttëli	V	keep company
wë	DET	the, that
wëlbëti	V	turn around, turn inside out
wëlé	PRO	that
wëlis	V	whistle
wëlis	N	suitcase
wëlluur	N	velvet
wëndéél	V	spin
wëndéélu	V	spin
wëñ	N	thread
wër	V	wander around
wër	V	go in a circle around; look for
wër	V	surround, crowd around
wëraan	V	go around in a circle
wëri	V	go around to the back door; go off somewhere
wërsëk	N	luck
wësin	V	have a baby, give birth
wëttéén	N	cotton
wëy	V	sing
wëy	V	sing about
wëy	N	song
wëy	PRT	yes
wëyëntu	V	sing idly
wi	DET	the; that
wicax	V	flick
wilé	PRO this
wis	V	sprinkle
wis	V	wet lightly; give extra
wisit	N	medical appointment
wisité	V	visit
wit	N	eight
wita	V	pluck
witees	N	speed
witéen	N	cotton
wii	PRO	this
wiiri-waara	V	loitering
wiis	N	screw
wiis	V	screw in
wocca	V	leave
wodd	V	wrap something
wodda	V	drop
woddu	V	wrap something like a sër around oneself
wokk	V	scratch
wokkatu	V	scratch oneself
wol	V	pound into flour
woli	V	go and pound grain into flour
wolis	V	whistle
wollu	V	save
Wolof	N	Wolof person; Wolof language
Wolofe	V	be Wolof-like
wolu	V	save
won	V	exhibit
wona	V	swallow
wondaal	V	spin
wone	V	show
wonewu	V	show of
woñ	N	thread
woñeeku	V	return
woññi	V	count; send back
woṉ	N	buttocks
woppeere	V	operate on
wor	V	betray
wori	V	end the month of fasting
worsag	N	luck
wosin	V	deliver, give birth
wote	V	vote
woteel	V	vote for
woto	N	car
wottu	V	keep away from
wow	V	be dry; be skinny
wowal	V	dry
wowle	V	be hard headed
wox	V	say
woxambaane	N	young man
woxaale	V	bargain
woxaat	V	repeat
woxtu	V	soliloquise
woxtu	V	soliloguy
woxtu	N	period
woy	V	sing
woy	V	sing about
woy	N	song
woyaan	V	praise
woyaankat	N	begger
woyaas	N	trip
woyaas	V	travel
woyaase	V	travel
woyof	V	be sheer; be light; be open
woyofaay	N	lightness
woyofaay	V	hit on the head with one’s knuckles
woo	V	call
woolu	V	try to get in touch with
woon	AUX	PST
woor	V	fast
woote	V	call
woowi	V	go and call
woowu	PRO	those
wooyi	V	go and call
wór	V	wander
wóy	N	song
wóólu	V	trust
wóóm	N	knee
wóór	V	be convinced
wu	PRO	REL.SG
wu	DET	that
wucu	V	vomit
wujj	N	female rival other girlfriend of one’s boyfriend; co-wife
wujja	N	co-wife
wujje	N	rivalry
wujjé	V	compete
wulli	V	tan
wullikat	N	tanner
wulóor	N	value
wund	N	cat
wure	V	gamble
wure	N	mandinka, mankala
wurus	N	gold
wuude	N	leatherworker, shoemaker
wut	V	look for
wute	V	be different
wutee	N	difference
wutee	V	be different
wuti	V	go and look for
wutlu	V	have others look for
wutsi	V	come and look for
wuutu	V	succeed
Wuy!	INTERJ	Ouch!
wuyoo	V	respond, answer with
wuyu	V	answer
xabaar	N	news
xabaar	V	gossip, spread the news
xac	N	dog; bad person
xac	V	fit in
xac-xajal	V	squeeze in
xaf	N	snips, join strips of cloth by stitching
xaftaan	N	type of long robe worn by men
xaj	N	dog
xajal	V	make room for
xajaaloo	V	be divided, separated
xajaan	V	boast
xaje	V	be mean; be vulgar
xal	N	hot charcoal
xala	V	be almost
xalaat	V	think about, meditate
xalaat	V	think that
xalaat	N	thought, meditation
xalam	N	type of stringed instrument
xalam	V	play the xalam
xale	N	child
xalel	N	child
xale-xalelu	V	pretend to be a child
xalif	N	religious leader
xalima	N	type of pen, usually cut from banmboo and used to write on àlluwa
xalimba	N	pen
xam	V	know
xam	N	white spot on the skin
xam	V	have a white spot on the skin, skin disease
xamal	V	inform
xamadi	V	have no manners
xamante 	V	know each other
xamb	V	light to kindle a fire
xamba	V	add wood to fire
xamee	V	be known for
xamul	V	not to know
xam-xam	N	knowledge
xanaa	PRT	I wonder, maybe
xanaa	V	should
xandoor	V	snore
xanjar	N	bronze, coins
xañ	V	deny
xapati	V	bite
xar	N	lamb; sheep
xar	V	cut, break
xar	V	be chapped and broken
xar	V	operate, tear
xar	N	operation
xaraf	V	be circumcised
xarafal	V	circumcise
xarat	V	cut, break
xaraam	V	be forbidden
xare	N	war
xarit	N	friend
xaritoo	V	be friends
xartum	N	chiffon
xaru	V	commit suicide
xaru	V	struggle
xar-xar	N	tear
xas	V	scold
xasan	V	itch
xasaw	V	stink
xasaw	V	smell like
xaste	N	haranguing
xat	V	be narrow; be tight; be busy
xatal	V	bother
xataraayu	V	struggle
xaw	V	just fail to
xaw	V	be sort of
xaxtandekku	V	force out lump
xayma	V	estimate
xaabu	V	gobble
xaacee	V	renounce
xaaci	V	lift
Xaadir	N	member of the Xaadriya Muslim sect
Xaadriya	N	member of the Xaadriya Muslim sect
xaaj	V	divide
xaaji	V	divide
xaaji-guddi	N	midnight
xaajo	N	part
xaajul	V	be not even half
xaal	N	melon
xaalis	N	money; silver
xaamaleku	V	recognize
xaamee	V	recognize
xaanu	N	pipe
xaaqataay	V	laugh loudly
xaar	V	wait
xaaraan	V	come by when others are eating, expecting an invitation to share the food
xaare	V	hate
xaat	ADV	so soon, already
xaaxtëndi	N	phlegm
xaaxtëndiku	V	clear one’s throat
xaay	V	be not yet ripe
xàcc	V	brandish a weapon
xàjjale	V	divide
xàjji	V	part one’s hair
xàjji	N	part in the hair
xàññ-xàññaaral	V	be visible	
xàmb	N	shrine
xàmmee	V	recognize
xàmp	V	bite
xànjar	N	coins; brass
xànq	N	wasp sp.
xàññaaral	V	be bright, visible
xàppatiku	V	have a piece broken off
xàtt	IDEO	very
xef	V	blink
xef	N	eyelash
xej	V	fit
xejem	V	have sand grains in food
xel	N	mind; intelligence; memory
xelmati	V	resemble
xemem	V	be lust
xemme	N	snuff
xepp	IDEO	very
xer	V	filter
xesew	V	smell bad
xesew	N	bad odor
xet	N	smell
xew	V	be fashionable
xew	N	celebration
xew	V	happen
xewi	N	out dated
xewle	V	be involved in events
xewle	V	be celebrating for
xewwi	V	be old fashioned
xew-xew	N	celebration
xey	V	leave early
xey	V	leave early in order to
xeeb	V	underestimate
xeebante	V	underestimate each other
xeej	N	lance
xeeli	V	pour
xeelu	V	wink
xeeñ	V	smell good
xeeñ	V	have a smell to
xeeñ	V	smell
xeeñal	N	incense
xeeñtu	V	sniff
xeep	V	judge to be inappropriate or not up to standard
xeer	N	rock
xeereer	V	have neither light nor dark skin
xees	V	have light skin, have a light complexion
xeesal	V	bleach one’s skin
xeet	N	race; ethnic group; type
xeetali	V	help, give
xeex	V	compete
xeex	V	fight for
xeex	N	fight, war
xélli	V	pour
xér	V	block view
xéy	V	work early in the morning
xëc	V	suffocate, to gasp for breath
xëcc 	V	pull toward oneself
xëdd	V	eat before morning prayers during Ramadam
xëdd	N	food eaten before morning prayers during Ramadam
xëlu	V	take off and run
xëm	V	faint; scorch or burn on the bottom
xërëm	V	receive charms and prayers against a rival from a sëriñ
xërëm	V	affected by charms or prayers directed against
xërëm	N	idol
xët	V	hit on the back
xët	N	blow on the back
xëtër	N	lung
xëtt	V	be torn through
xëy	V	leave early
xëy	V	leave early in order to
xibaar	N	news, message
ximaleku	V	recover from a faint
ximi	V	recover from a faint
ximmëliku	V	come to
ximmi	V	come to
xippi	V	open one’s eyes
xiibon	V	be malnourished
xiif	V	be hungry
xiif	N	hunger
xiim	V	brew “ataya”
xiimkat	N	one who brews “ataya”
xiin	V	be cloudy
xiir	V	motive
xiir	N	fishing line
xiis	V	be wicked
xiis	N	metal scourer, palm leaves
xiis	N	used for scrubbling
xiix	V	leave
xob	N	leaf
xobe	V	take things seriously
xoc	V	choke
xocc	IDEO	very
xojogaane	N	hunchback
xoju	V	be well dressed
xol	N	heart; true love
xol	V	feed by force
xomal	V	put to sleep
xonjam	V	receive charms and prayers against from a sëriñ
xonjam	N	charm, object blessed by a sëriñ and used against a rival
xonjamkat	N	sëriñ or marabout with the power to bless charms and offer prayers
xonjom	V	receive charms and prayers against from a sëriñ
xonjom	N	charm, object blessed by a sëriñ and used against a rival, amulet
xonjomkat	N	sëriñ or marabout with the power to bless charms and offer prayers
xonq	V	be red
xonq	N	red
xonxa	N	red
xodd	ADJ very
xop	N	leaf
xor	N	seashell
xormbet	V	be tasteless
xorom	N	salt
xorom	V	salt
xorom	N boredom
xorome	V	be salty
xosi	V	scratch
xooc	V	soak
xooda	N	stork
xool	V	look
xoole	V	stare
xooli	V	peel
xoolit	N	peelings
xooñ	N	caked residue at the bottom of the cooking pot
xoor	N	shell
xoos	V	scrape
xoos	V	be hungry
xoosu	V	be scraped, have a scrape
xoos-xoos	N	scrape
xoota	N	empty container
xooti	V	tear
xootit	N	shed
xoox	N	seed; hard drugs
xoox	V	be exhausted
xódd	N	type of bird with a long neck
xóllééku	V	be peeled
xólli	V	peel
xóllit	N	peel
xóm	V	be charred
xóm	V	faint
xómm	IDEO	well
xótt	N	empty shell
xótti	V	rip out
xóttil	V	have made, sewn for
xóóñ	N	layer of hardened well-cooked rice and the layer of rice burned onto the bottom of a pan underneath it
xóóñ	V	be horny
xóót	V	be deep; be pure; be hard to hear
xóótëxóót	V	be very deep
xóóyël	V	dissolve in a liquid
xubël	V	agitate to make suds
xuca	N	umbilical cord
xulaan	N	witch
xuliñé	N	type of bitter vegetable
xuloo	N	quarrel
xulóo	V	fight
xulóó	V	argue
xulóó	N	argument
xultu	V	grumble
xuluñel	N	bitter tomatoes
xuluñé	N	type of bitter vegetable
xumb	V	be exciting; be busy
xumba	V	be conspicuous
xumbal	V	be interesting
xumbël	V	make exciting 
xup	V	be sudsy; have a bubbly eruption
xuréet	N	whooping cough
xuréét	V	have whooping cough
xuréét	N	whooping cough
xurfaan	V	have a cold; cold
xuta	V	be afraid, timid
xutba	N	sermon
xutbë	N	sermon
xuuge	V	be humpbacked
xuuge	N	hunchback
xuur	V	be rusty; be deep, scratchy
xuur	N	testicles
xuus	V	wade
xuuxal	V	scare
ya	DET	the; that
ya	PRO	the ones that
yab	V	consider one’s equal
yabaate	V	consider everyone one’s equal
yadaax	V	be slack
yafal	V	rare
yakk	V	remove from the cooking pot
yal	N	lizard
yalandi	V	rinse
yale	DET	these
yaleef	N	spirit
yëlé	PRO	these
yalwaan	V	beg
yalwaankat	N	beggar
yam	V	be the same
yam	V	have the same
yam	V	quiet down; know how to behave
yam	V	stop at
yamale	V	stop treat equally
yamb	N	bee
yan	Q	which, what?
yan	W	which, which ones?
yan	V	put a burden on head
yan	V	place on head
yangi	V	be:2PL.PRS
yanq	V	be loose
yanu	V	have a burden; be pregnant
yanu	V	put on one’s head, have on one’s head
yanxa	V	be loose
yap	V	load
yar	V	raise; show the right thing to do, train, breed
yar	N	whip
yaradeku	V	be untrained
yaram	N	weight; body
yaru	V	be polite, be shy
yat	N	branch
yatt	V	carve
yaw	PRO	2SG
yax	N	bone; baby tooth
yaa	V	be wide; be nice
yaa	PRO	2SG.SUB.FOC
yaa	N	place, mum, nest, residence
yaabi	V	fade, take out of the mouth
yaaga	V	stay ling
yaak	V	clean
yaakaar	N	hope, believe
yaakaar	V	hope, believe
yaakamti	V	be in a hurry
yaala	N	God
yaandóor	N	slumber, slumbering
yaapa	N	meat
yaar	N	yard
yaaram	N	good person, religious person
yaaraam	V	be gentile
yaasa	N	bar-b-qued meat or fish
yaatal	V	make comfortable, feel comfortable, enlarge, accommodate
yaatu	V	be wide; be open
yaax	N	fish
yaaxa	V	destroy
yaaxu	V	be broken
yaay	N	mother
Yaay	N	mother, a lady's name
yaay	V	wander
yàbb	V	have one's mouth hanging open
yàbbaaral	V	have one’s mouth hanging open
yàbbi	V	drop out of one’s mouth
yàbb-yàbbaaral	V	have one’s mouth hanging open
yàgg	V	take a long time
yàgg	V	be located for a long time
yàgg	V	have been a long time
yàgg	V	have beening a long time
yàggayàgg	ADV	long, long ago
yàkkali	V	widen
yàkkali	V	spread out
yàkkamti	V	be in a hurry
yàkkamti	V	be eager for
yàkkamti	V	be eager to
Yàlla	N	God
yàmbalaṉ	V	be open wide, have an open door
yànga	PRO	2SG.REM.IPFV
yànga	PRO	2SG
yàngi	PRO	2SG.NEUT.PROX.IPFV
yàngi	AUX	be:2SG.LOC
yàpp	N	meat
yàg	V	break off, destroy
yàqu	V	be broken
yàwweeku	V	be stretched
yàwwi	V	stretch
yebbi	V	unload
yedd	V	give advice to
yeddaate	V	give advice
yedaax	V	be slack
yegg	V	arrive
yeggale	V	finish
yeggële	V	finish
yegsi	V	arrive
yek	V	be afraid of
yeketaan	V	rape
yeketaankat	N	rapist
yelimaan	N	imam
yem	V	have the same
yem	V	settle down; to know how to behave
yem	V	stop at
yemale 	V	stop; make behave; treat equally
yemmoog	ADV	at the same time that
yen	V	put a burden on head
yen	V	place on head
yeneen	ADJ	other
yendoo	V	spend the day in
yendu	V	spend the day
yeneen	PRO	some other things
yeneen	DET	other
yenn	DET	some, certain
yenneeku	V	take a burden off one’s head
yenni	V	take a burden off one’s head
yenu	V	have a burden; to be pregnant
yenu	V	put on one’s head, have on one’s head
yere	N	article of clothing
yewën	V	be kind
yewwi	V	untie
yee	V	wake up
yee	DET	these
yee	PRO	these
yeebane	V	announce
yeel	N	shin
yeet	V	make a noise that wakes people up
yeew	V	tie
yeew	N	python
yeewu	V	wake up; be clever
yéefar	N	pagan
yées	V	be worse
yéet	N	snail
yéré	N	clothes
yérém	V	be pity, sympathize
yérémantalu	N	snivel
yérmaande	N	pity, sympathy
yét	N	stuff
yééféér	N	non-Muslim
yéég	V	go up
yéék	V	go up
yéén	PRO	2PL
yéén	N	eyebrow
yéénékat	N	muezzin
yéénë	PRO	2PL.SUB.FOC
yéénëngë	PRO	2PL.REM.IPFV
yéénëngë	V	be.at:2PL
yéénëngi	PRO	2PL.NEUT.PROX
yéénëngi	PRO	2PL
yéés	V	be the worst
yéés	V	be worse than
yéét	N	conch
yééx	V	be slow
yég	V	feel; treat courteously
yégël	V	announce
yékëti	V	lift
yéy	V	chew
yéy	V	do the right thing
yéyët	V	chew into little pieces
yë	DET	the; that
yë	PRO	the ones that
yëf	N	thing
yëg	V	feel; treat courteously
yëg	V	be informed
yëgal	V	notify
yëgle	V	announce
yëkëti	V	lift
yëkk	N	ox
yëlé	DET	these
yëlé	PRO	these
yëmbëx	V	be loose
yëngal	V	shake
yëngël	V	mix with a spoon; shake; disturb
yëngëtu	V	shake; be loose
yëngu	V	move
yëngu	V	be shaken
yëp	ADJ	every
yëpp	DET	all
yëpp	PRO	everything
yër	V	spy on
yërëm	V	feel sorry for
yërëmaate	V	feel sorry for everyone, be a soft touch
yërëmtëlu	V	feel sorry for oneself, act as if things are worse than they are
yërmëndé	N	compassion
yëwut	N	halwa
yëy	V	chew
yëy	V	do the right thing
yëyët	V	chew into little pieces
yi	DET	the; that
yi	PRO	the ones that
yilé	DET	these
yilé	PRO	these
yilif	V	be the superior of
yinddé	N	steamer
yiw	V	be clean-cut; look good
yiwëdu	V	look bad
yii	DET	these
yii	PRO	these
yiiw	V	be self respect
yiix	V	be slow
yobbaale	V	take along
yobbante	V	send on an errand
yobbante	V	send to get or take
yobbante	N	thing that someone has brought for one from someone else
yobbu	V	take away
yokk	V	add more
yokk	V	have hair extensions
yokku 	V	increase
yolet	V	be purple
yolom	V	be loose-fitting; be weak
yolox	V	be weak
yomb	V	be inexpensive; be easy
yomb	N	type of vegetable
yomba	V	be cheap, easy
yonnént	N	prophet, messenger
yonni	V	send
yoóbu	V	carry away
yoq	N	bone marrow
yoqóól	V	hiccup
yor	V	hold
yor	V	take care of
yore	V	hold
yos	N	possessions
yot	V	hand to
yow	PRO	2SG
yoxos	N	oyster
yoo	N	mosquito
yoo	Q	which, which ones
yooleku	V	sneak
yoom	V	be impotent
yoon	N	dirt road; time; business; way
yoonam	ADV	on one’s way
yoonée	V	send
yoor	V	be dangle
yooru	V	be hanging
yoor-yoor	N	midmorning
yoot	V	slink
yooxi	V	loose interest
yooy	V	be thin
yooy	V	melt
yooyu	DET	those
yooyu	PRO	those
yóbaale	V	take along
yónnéé	V	send
Yónnént	N	Prophet sent by God-especially
yónni	V	send to
yóobal	N	present
yóoka	V	increase
yóoku	V	increase
yóqëmtiku	V	stand on tiptoe to look at something
yóótu	V	reach for
yu	PRO	which, which ones
yu	PRO	REL.PL
yu	DET	ones
yuli	V	empty, unstuff
yumbur	V	be loose
yumbux	V	be loose
yumpaañ	N	uncle’s wife, aunty
yurndoo	V	peep
yurndu	V	peep
yuur	N	brain
yuus-yaas	V	walk
yuut	V	drool; have one’s mouth water
yuut	V	salivates
yuuxu	V	scream
